url,old_path,new_path,old_loc,new_loc,old_block,new_block,old_disciplined,new_disciplined,old_undisciplined,new_undisciplined,commit_hash,author
https://github.com/vim/vim,src/misc1.c,src/misc1.c,5706,5787,226,231,170,174,56,57,21cf823a906f1f66391a145a976fdae8e98e0394,Committer [name=Bram Moolenaar; email=Bram@vim.org]
https://github.com/vim/vim,src/screen.c,src/screen.c,6440,6481,459,462,296,298,163,164,592e0a2a1dbc542134c3fd88b4cdfa40e258f41b,Committer [name=Bram Moolenaar; email=Bram@vim.org]
https://github.com/vim/vim,src/os_w32exe.c,src/os_w32exe.c,103,215,19,24,15,19,4,5,15d0a8c77dad867b69822e2fd8f9f6bbcf765c48,Committer [name=Bram Moolenaar; email=Bram@vim.org]
https://github.com/vim/vim,src/gui_motif.c,src/gui_motif.c,2394,2726,80,82,65,68,15,14,dfccaf0f00e8308eae09cb8f012fce3e56097f0f,Committer [name=Bram Moolenaar; email=Bram@vim.org]
https://github.com/vim/vim,src/gui_x11.c,src/gui_x11.c,2765,2608,115,111,89,86,26,25,1c2fda2097fc85f3677895f18adbbdc7f64bd807,Committer [name=Bram Moolenaar; email=Bram@vim.org]
https://github.com/vim/vim,src/os_unix.c,src/os_unix.c,4618,4613,432,430,351,350,81,80,2fa15e6c7bf4181946b64c04b9c99bfd269535af,Committer [name=Bram Moolenaar; email=Bram@vim.org]
https://github.com/vim/vim,src/eval.c,src/eval.c,9547,9747,364,345,326,311,38,34,c70646c652f5dfdcf6706b19c31f3fc62aea9621,Committer [name=Bram Moolenaar; email=Bram@vim.org]
https://github.com/vim/vim,src/eval.c,src/eval.c,10295,10609,345,352,311,316,34,36,0d6602271c5d1954e7803a3f857d0f5d42851f84,Committer [name=Bram Moolenaar; email=Bram@vim.org]
https://github.com/vim/vim,src/ex_docmd.c,src/ex_docmd.c,7419,7426,334,337,249,253,85,84,748bf0374b1dd63e7e3157237185030c47ae0c2c,Committer [name=Bram Moolenaar; email=Bram@vim.org]
https://github.com/vim/vim,src/quickfix.c,src/quickfix.c,2085,2114,51,54,49,51,2,3,748bf0374b1dd63e7e3157237185030c47ae0c2c,Committer [name=Bram Moolenaar; email=Bram@vim.org]
https://github.com/vim/vim,src/ex_getln.c,src/ex_getln.c,4353,4342,192,185,144,141,48,44,26a60b45245080771bc2452b2634cb1f5acd60ed,Committer [name=Bram Moolenaar; email=Bram@vim.org]
https://github.com/vim/vim,src/gui_mac.c,src/gui_mac.c,3926,4415,201,264,182,235,19,29,26a60b45245080771bc2452b2634cb1f5acd60ed,Committer [name=Bram Moolenaar; email=Bram@vim.org]
https://github.com/vim/vim,src/mbyte.c,src/mbyte.c,4267,4271,156,158,144,145,12,13,df177f679e950a2ab2ad5fe7d45c1daface004d7,Committer [name=Bram Moolenaar; email=Bram@vim.org]
https://github.com/vim/vim,src/option.c,src/option.c,7974,8021,825,828,604,609,221,219,26a60b45245080771bc2452b2634cb1f5acd60ed,Committer [name=Bram Moolenaar; email=Bram@vim.org]
https://github.com/vim/vim,src/main.c,src/main.c,2461,2468,270,270,237,238,33,32,5313dcb75ac76501f23d21ac94efdbeeabc860bc,Committer [name=Bram Moolenaar; email=Bram@vim.org]
https://github.com/vim/vim,src/os_unix.c,src/os_unix.c,4647,4822,432,445,352,361,80,84,df177f679e950a2ab2ad5fe7d45c1daface004d7,Committer [name=Bram Moolenaar; email=Bram@vim.org]
https://github.com/vim/vim,src/regexp.c,src/regexp.c,4805,4966,114,119,74,76,40,43,df177f679e950a2ab2ad5fe7d45c1daface004d7,Committer [name=Bram Moolenaar; email=Bram@vim.org]
https://github.com/vim/vim,src/eval.c,src/eval.c,13919,14007,371,375,336,338,35,37,7383034c0ab657158c4c69146254beffdea4859e,Committer [name=Bram Moolenaar; email=Bram@vim.org]
https://github.com/vim/vim,src/ex_cmds.c,src/ex_cmds.c,4804,4808,226,226,164,165,62,61,fdac490defec76f1c7720c190d6a5b3d6b366748,Committer [name=Bram Moolenaar; email=Bram@vim.org]
https://github.com/vim/vim,src/ex_docmd.c,src/ex_docmd.c,7657,7647,347,350,262,263,85,87,52b4b557a26e742a14bd6da4dff55f8e167af04e,Committer [name=Bram Moolenaar; email=Bram@vim.org]
https://github.com/vim/vim,src/regexp.c,src/regexp.c,5329,5281,124,114,82,75,42,39,e4efc3b27052385c6466f133ac1b0931b7e4c855,Committer [name=Bram Moolenaar; email=Bram@vim.org]
https://github.com/vim/vim,src/quickfix.c,src/quickfix.c,2219,2223,59,59,56,57,3,2,bc7aa85d8a1c3e5c74b68225702bd5b83b4a8f56,Committer [name=Bram Moolenaar; email=Bram@vim.org]
https://github.com/vim/vim,src/regexp.c,src/regexp.c,5043,5329,125,124,80,82,45,42,bc7aa85d8a1c3e5c74b68225702bd5b83b4a8f56,Committer [name=Bram Moolenaar; email=Bram@vim.org]
https://github.com/vim/vim,src/gui.c,src/gui.c,3585,3561,281,275,222,217,59,58,3918c950c99a626a9fa40e58d7976bffb2e17f5e,Committer [name=Bram Moolenaar; email=Bram@vim.org]
https://github.com/vim/vim,src/ops.c,src/ops.c,4715,4726,226,228,165,166,61,62,e2cc9702a6ddb033ea289a1269f14e7ae076c3ef,Committer [name=Bram Moolenaar; email=Bram@vim.org]
https://github.com/vim/vim,src/os_amiga.c,src/os_amiga.c,1135,1113,70,66,31,29,39,37,5b743bfc4da86c3b15073acee25d3e2afc684106,Committer [name=Bram Moolenaar; email=Bram@vim.org]
https://github.com/vim/vim,src/os_msdos.c,src/os_msdos.c,2001,1982,91,87,80,77,11,10,916b7afcbb6f3cf7ae9e4699c47a5ec885a56af2,Committer [name=Bram Moolenaar; email=Bram@vim.org]
https://github.com/vim/vim,src/syntax.c,src/syntax.c,6203,6251,124,126,103,104,21,22,e2cc9702a6ddb033ea289a1269f14e7ae076c3ef,Committer [name=Bram Moolenaar; email=Bram@vim.org]
https://github.com/vim/vim,src/charset.c,src/charset.c,1329,1398,72,78,47,48,25,30,6bb683663ad7ae9c303284c335a731a13233c6c2,Committer [name=Bram Moolenaar; email=Bram@vim.org]
https://github.com/vim/vim,src/spell.c,src/spell.c,512,778,7,14,2,10,5,4,fc73515f7ba66b47705265bb8d01c6bec5df09c4,Committer [name=Bram Moolenaar; email=Bram@vim.org]
https://github.com/vim/vim,src/os_unix.c,src/os_unix.c,4826,4807,445,441,361,359,84,82,4317d9b4867621ec572a3a4010587d59ecc51813,Committer [name=Bram Moolenaar; email=Bram@vim.org]
https://github.com/vim/vim,src/spell.c,src/spell.c,2951,3305,18,23,15,19,3,4,63d5a1e57b225dd90ac6d5f24876e737683961ee,Committer [name=Bram Moolenaar; email=Bram@vim.org]
https://github.com/vim/vim,src/spell.c,src/spell.c,3305,3476,23,26,19,21,4,5,2cf8b301df39f742c07d10dadbbe19218dcc1845,Committer [name=Bram Moolenaar; email=Bram@vim.org]
https://github.com/vim/vim,src/charset.c,src/charset.c,1413,1609,78,84,48,56,30,28,0cb032ecb8b03d9c387b89c9f26158924f216e67,Committer [name=Bram Moolenaar; email=Bram@vim.org]
https://github.com/vim/vim,src/buffer.c,src/buffer.c,4030,4030,274,271,218,217,56,54,9c13b359b496c5268702776105a9f87b269e84f3,Committer [name=Bram Moolenaar; email=Bram@vim.org]
https://github.com/vim/vim,src/message.c,src/message.c,2374,2846,124,145,76,96,48,49,9c13b359b496c5268702776105a9f87b269e84f3,Committer [name=Bram Moolenaar; email=Bram@vim.org]
https://github.com/vim/vim,src/screen.c,src/screen.c,6478,6483,459,458,294,295,165,163,35c54e56513137e58a649983fbab6c490820462e,Committer [name=Bram Moolenaar; email=Bram@vim.org]
https://github.com/vim/vim,src/ex_cmds.c,src/ex_cmds.c,4788,4906,223,225,162,163,61,62,67fe1a13369f686758e5f4f43e1e842fef9f60f6,Committer [name=Bram Moolenaar; email=Bram@vim.org]
https://github.com/vim/vim,src/digraph.c,src/digraph.c,2322,2316,30,30,24,23,6,7,6c0b44b5bf930129a57ff71b1d0c7ffcbc6b0bf5,Committer [name=Bram Moolenaar; email=Bram@vim.org]
https://github.com/vim/vim,src/spell.c,src/spell.c,3557,1859,26,14,21,12,5,2,51485f06246966898f7c00e2e53b1ba4c6855cf7,Committer [name=Bram Moolenaar; email=Bram@vim.org]
https://github.com/vim/vim,src/charset.c,src/charset.c,1629,1358,87,74,59,49,28,25,45eeb13324b1d4fa80c1e4ed872bebd1202bf1f0,Committer [name=Bram Moolenaar; email=Bram@vim.org]
https://github.com/vim/vim,src/spell.c,src/spell.c,1867,2200,14,26,12,22,2,4,cfc6c43ce2fe59ccc7e48785e6c20126f0ee9d7f,Committer [name=Bram Moolenaar; email=Bram@vim.org]
https://github.com/vim/vim,src/screen.c,src/screen.c,6483,6473,458,458,295,296,163,162,75c50c46a69d25ac94a55bae8a9642316d52be00,Committer [name=Bram Moolenaar; email=Bram@vim.org]
https://github.com/vim/vim,src/misc2.c,src/misc2.c,4000,4032,185,192,133,136,52,56,c4a06d34471d21532a3e0535e547b3d797992350,Committer [name=Bram Moolenaar; email=Bram@vim.org]
https://github.com/vim/vim,src/eval.c,src/eval.c,14183,14160,377,372,340,339,37,33,0e4d877ed8a23c80a24b0cd5bd0c61cc7db93df2,Committer [name=Bram Moolenaar; email=Bram@vim.org]
https://github.com/vim/vim,src/spell.c,src/spell.c,2459,2517,32,34,22,23,10,11,3982c541060fd8f74cb6547dc03a7c76b0ef1167,Committer [name=Bram Moolenaar; email=Bram@vim.org]
https://github.com/vim/vim,src/spell.c,src/spell.c,3986,4211,49,69,30,47,19,22,9f30f50471678a0a986c30b50dce705bdcc991dc,Committer [name=Bram Moolenaar; email=Bram@vim.org]
https://github.com/vim/vim,src/spell.c,src/spell.c,4211,4571,69,97,47,58,22,39,ea424166e2a53649eea8d8899fc9294ca023964c,Committer [name=Bram Moolenaar; email=Bram@vim.org]
https://github.com/vim/vim,src/screen.c,src/screen.c,6473,6478,458,457,296,294,162,163,e756604ff50151c668154e64b56f615badffee2c,Committer [name=Bram Moolenaar; email=Bram@vim.org]
https://github.com/vim/vim,src/spell.c,src/spell.c,5290,5503,78,82,40,42,38,40,0c40586a7beb81ed7393dcf598cbce4b79f27ab9,Committer [name=Bram Moolenaar; email=Bram@vim.org]
https://github.com/vim/vim,src/spell.c,src/spell.c,5806,5948,84,88,43,44,41,44,cf6bf39f68a46e4cabb128c4d33c4c08b27b2b9f,Committer [name=Bram Moolenaar; email=Bram@vim.org]
https://github.com/vim/vim,src/ex_cmds2.c,src/ex_cmds2.c,5524,5537,241,243,194,195,47,48,d9fba318b8465da7da0b19ec1b38f9371f46a173,Committer [name=Bram Moolenaar; email=Bram@vim.org]
https://github.com/vim/vim,src/os_win32.c,src/os_win32.c,3458,3457,147,147,125,126,22,21,702517dd70c25611ea07c306275cb76f0355cb51,Committer [name=Bram Moolenaar; email=Bram@vim.org]
https://github.com/vim/vim,src/os_msdos.c,src/os_msdos.c,1982,1981,87,87,77,78,10,9,39a58ca3d414b0b1600f5e2b1b9ef2d8d7031c15,Committer [name=Bram Moolenaar; email=Bram@vim.org]
https://github.com/vim/vim,src/spell.c,src/spell.c,5948,6486,88,99,44,54,44,45,a1ba811ac90665fa347eb58929e22681e1c99669,Committer [name=Bram Moolenaar; email=Bram@vim.org]
https://github.com/vim/vim,src/option.c,src/option.c,8184,8196,847,849,622,623,225,226,24bbcfe8fe62ea43b1cea86243be4fdc8794140b,Committer [name=Bram Moolenaar; email=Bram@vim.org]
https://github.com/vim/vim,src/option.c,src/option.c,8194,8238,849,853,623,625,226,228,0d9c26dd8333aae4b20015f13fe2e8e1f07037bd,Committer [name=Bram Moolenaar; email=Bram@vim.org]
https://github.com/vim/vim,src/os_unix.c,src/os_unix.c,4862,4862,449,449,366,367,83,82,0e634daa954bbdf882575a15a746edf325420cee,Committer [name=Bram Moolenaar; email=Bram@vim.org]
https://github.com/vim/vim,src/misc1.c,src/misc1.c,5965,6158,240,245,184,188,56,57,231334e6efbf3a7f89183f8257e09492534a5f8c,Committer [name=Bram Moolenaar; email=Bram@vim.org]
https://github.com/vim/vim,src/os_mac.c,src/os_mac.c,993,865,38,33,34,30,4,3,027436338b4b3e746ae5087b8a01c7404619d97b,Committer [name=Bram Moolenaar; email=Bram@vim.org]
https://github.com/vim/vim,src/os_unix.c,src/os_unix.c,4862,4723,449,445,367,364,82,81,027436338b4b3e746ae5087b8a01c7404619d97b,Committer [name=Bram Moolenaar; email=Bram@vim.org]
https://github.com/vim/vim,src/spell.c,src/spell.c,7278,7458,115,123,62,68,53,55,329cc7e429db7a3fd77143ea3ea489911680944e,Committer [name=Bram Moolenaar; email=Bram@vim.org]
https://github.com/vim/vim,src/edit.c,src/edit.c,5940,5982,352,354,253,254,99,100,488c6512d9fbe998b2d6ef64bd50d323ccb6607f,Committer [name=Bram Moolenaar; email=Bram@vim.org]
https://github.com/vim/vim,src/spell.c,src/spell.c,8638,8916,133,142,76,83,57,59,6de6853ce389e34ee175884bf9f193b33a0e60c8,Committer [name=Bram Moolenaar; email=Bram@vim.org]
https://github.com/vim/vim,src/spell.c,src/spell.c,8952,9054,142,145,83,85,59,60,ac6e65f88da446bc764ff13a23d854fd72ffedcf,Committer [name=Bram Moolenaar; email=Bram@vim.org]
https://github.com/vim/vim,src/message.c,src/message.c,3272,3307,157,159,87,88,70,71,bb15b658647d8eca01e67df871f7cb5ed95e2534,Committer [name=Bram Moolenaar; email=Bram@vim.org]
https://github.com/vim/vim,src/option.c,src/option.c,8305,8322,864,867,629,630,235,237,1c7715dfe4f29be631b78699cbca786d30852886,Committer [name=Bram Moolenaar; email=Bram@vim.org]
https://github.com/vim/vim,src/ex_cmds.c,src/ex_cmds.c,5052,5053,232,232,166,168,66,64,bba577a24244bd5d95044ab4bc23628e48d1ff08,Committer [name=Bram Moolenaar; email=Bram@vim.org]
https://github.com/vim/vim,src/memline.c,src/memline.c,3184,3236,104,109,82,86,22,23,d5bc83f576a26dd27fab558fdee472838b66bbb4,Committer [name=Bram Moolenaar; email=Bram@vim.org]
https://github.com/vim/vim,src/os_macosx.c,src/os_macosx.c,502,503,5,6,5,4,0,2,9372a11ca67d6bdec9c16407a941cb8094eec3b6,Committer [name=Bram Moolenaar; email=Bram@vim.org]
https://github.com/vim/vim,src/gui_mac.c,src/gui_mac.c,4419,3863,262,111,233,104,29,7,2c7a29c7fd2e51236a00435ed37e280cb98a2131,Committer [name=Bram Moolenaar; email=Bram@vim.org]
https://github.com/vim/vim,src/memline.c,src/memline.c,3236,3303,109,115,86,90,23,25,900b4d77f00b3ab7503d5e2865eca61ce5005c69,Committer [name=Bram Moolenaar; email=Bram@vim.org]
https://github.com/vim/vim,src/fileio.c,src/fileio.c,6634,6733,389,389,283,285,106,104,b0bf8580c38d51a44ffe973fef946e538df16dac,Committer [name=Bram Moolenaar; email=Bram@vim.org]
https://github.com/vim/vim,src/ex_docmd.c,src/ex_docmd.c,7753,7778,354,353,266,264,88,89,05a7bb363b6ae132b7f2550be1a588e481a5dfa3,Committer [name=Bram Moolenaar; email=Bram@vim.org]
https://github.com/vim/vim,src/option.c,src/option.c,8331,8372,867,870,630,632,237,238,b71eaaeaa8193b0cbb67496de6ad16ced80b8b09,Committer [name=Bram Moolenaar; email=Bram@vim.org]
https://github.com/vim/vim,src/main.c,src/main.c,2612,2623,274,277,242,244,32,33,33aec765bdc2096f123c5a4c61f8948a61aa9ef5,Committer [name=Bram Moolenaar; email=Bram@vim.org]
https://github.com/vim/vim,src/spell.c,src/spell.c,10716,10733,162,165,101,103,61,62,b8a7b560b1c25a059dfb57cbe40f0a3f98ed8e97,Committer [name=Bram Moolenaar; email=Bram@vim.org]
https://github.com/vim/vim,src/tag.c,src/tag.c,2776,2869,168,171,107,108,61,63,b8a7b560b1c25a059dfb57cbe40f0a3f98ed8e97,Committer [name=Bram Moolenaar; email=Bram@vim.org]
https://github.com/vim/vim,src/globals.h,src/globals.h,811,818,144,146,135,136,9,10,754b56089f334509ee23f70fe9d046120e91f0e6,Committer [name=Bram Moolenaar; email=Bram@vim.org]
https://github.com/vim/vim,src/edit.c,src/edit.c,6379,6463,363,366,260,262,103,104,c7453f52d4eb5a5259b6b587d62b7e99e1ebdd10,Committer [name=Bram Moolenaar; email=Bram@vim.org]
https://github.com/vim/vim,src/ex_docmd.c,src/ex_docmd.c,8014,7965,369,359,273,267,96,92,2a0449d129e211ce0b87a248e6205a11b49a203c,Committer [name=Bram Moolenaar; email=Bram@vim.org]
https://github.com/vim/vim,src/window.c,src/window.c,4175,4207,226,230,180,183,46,47,2a0449d129e211ce0b87a248e6205a11b49a203c,Committer [name=Bram Moolenaar; email=Bram@vim.org]
https://github.com/vim/vim,src/screen.c,src/screen.c,6788,6830,472,480,307,312,165,168,faa959a8700219bd1726943cbb956001b5f737e4,Committer [name=Bram Moolenaar; email=Bram@vim.org]
https://github.com/vim/vim,src/structs.h,src/structs.h,1364,1365,146,146,102,101,44,45,faa959a8700219bd1726943cbb956001b5f737e4,Committer [name=Bram Moolenaar; email=Bram@vim.org]
https://github.com/vim/vim,src/ex_cmds.c,src/ex_cmds.c,5071,5079,236,237,172,174,64,63,2a3f7eeebfa05a33cc1d8fbba66a3dff976e8dd7,Committer [name=Bram Moolenaar; email=Bram@vim.org]
https://github.com/vim/vim,src/screen.c,src/screen.c,6830,6871,480,482,312,313,168,169,238a564935abe36832b267f32b5487556c640d00,Committer [name=Bram Moolenaar; email=Bram@vim.org]
https://github.com/vim/vim,src/option.c,src/option.c,8480,8493,891,894,651,652,240,242,5c8837f9d7785c65c40f1485a779cc886750a5e9,Committer [name=Bram Moolenaar; email=Bram@vim.org]
https://github.com/vim/vim,src/fileio.c,src/fileio.c,6838,6852,392,395,285,286,107,109,03f4855fc252dd389622715dd56cbc49423057ba,Committer [name=Bram Moolenaar; email=Bram@vim.org]
https://github.com/vim/vim,src/os_win32.c,src/os_win32.c,3452,3499,147,149,126,127,21,22,03f4855fc252dd389622715dd56cbc49423057ba,Committer [name=Bram Moolenaar; email=Bram@vim.org]
https://github.com/vim/vim,src/buffer.c,src/buffer.c,4119,4161,276,282,222,226,54,56,e1438bb8d0b7a48f712458e68755ab8b66d92ace,Committer [name=Bram Moolenaar; email=Bram@vim.org]
https://github.com/vim/vim,src/tag.c,src/tag.c,2871,2883,171,173,108,107,63,66,a23ccb8ac6c470d72eb3d081625926965d3a9f52,Committer [name=Bram Moolenaar; email=Bram@vim.org]
https://github.com/vim/vim,src/buffer.c,src/buffer.c,4161,4173,282,283,226,225,56,58,b475fb917b0de463812afe6cc84b8e604d780da9,Committer [name=Bram Moolenaar; email=Bram@vim.org]
https://github.com/vim/vim,src/eval.c,src/eval.c,15661,15734,397,404,365,370,32,34,a55252087b1b771b0a1a509d2ac90067404287d7,Committer [name=Bram Moolenaar; email=Bram@vim.org]
https://github.com/vim/vim,src/search.c,src/search.c,4017,4025,137,137,82,81,55,56,87b5ca5172eb9e61f72f54f598d6d2ad646a8a76,Committer [name=Bram Moolenaar; email=Bram@vim.org]
https://github.com/vim/vim,src/getchar.c,src/getchar.c,3378,3435,144,151,100,105,44,46,4e42719355b7e1c968c7de0c51588bd744cdf034,Committer [name=Bram Moolenaar; email=Bram@vim.org]
https://github.com/vim/vim,src/ex_cmds.c,src/ex_cmds.c,5107,5107,239,242,176,178,63,64,a5b6ad13efe36a94adccbc5c844903bf74dc3f05,Committer [name=Bram Moolenaar; email=Bram@vim.org]
https://github.com/vim/vim,src/spell.c,src/spell.c,10980,10984,170,172,106,107,64,65,f71a3db47e928aaeea83c7bea011188d4898d249,Committer [name=Bram Moolenaar; email=Bram@vim.org]
https://github.com/vim/vim,src/screen.c,src/screen.c,6986,7077,486,502,316,329,170,173,600dddcf66a3540017804a72f407d4c3d48b0cc6,Committer [name=Bram Moolenaar; email=Bram@vim.org]
https://github.com/vim/vim,src/edit.c,src/edit.c,6733,6741,378,381,268,269,110,112,b9a02fc557ac586b194a80d5ef293d4465f95953,Committer [name=Bram Moolenaar; email=Bram@vim.org]
https://github.com/vim/vim,src/structs.h,src/structs.h,1399,1407,151,154,105,106,46,48,b9a02fc557ac586b194a80d5ef293d4465f95953,Committer [name=Bram Moolenaar; email=Bram@vim.org]
https://github.com/vim/vim,src/misc1.c,src/misc1.c,6189,6179,245,244,187,185,58,59,95e9b49537e5e6c2d8aa38595afbf404f7f483e6,Committer [name=Bram Moolenaar; email=Bram@vim.org]
https://github.com/vim/vim,src/ex_getln.c,src/ex_getln.c,4651,4696,204,206,159,160,45,46,efd2bf158afeb2337dcb5a62c6198d6d2fb7cd5f,Committer [name=Bram Moolenaar; email=Bram@vim.org]
https://github.com/vim/vim,src/edit.c,src/edit.c,6741,6740,381,381,269,268,112,113,2eb25daffd66cc323c039b624af8f4630f2fbf8f,Committer [name=Bram Moolenaar; email=Bram@vim.org]
https://github.com/vim/vim,src/regexp.c,src/regexp.c,5480,5484,121,121,81,80,40,41,efd2bf158afeb2337dcb5a62c6198d6d2fb7cd5f,Committer [name=Bram Moolenaar; email=Bram@vim.org]
https://github.com/vim/vim,src/gui.c,src/gui.c,3731,3751,282,287,224,226,58,61,371d5403d0dc6411f6f17c5b472c1cfcac6789e4,Committer [name=Bram Moolenaar; email=Bram@vim.org]
https://github.com/vim/vim,src/structs.h,src/structs.h,1422,1429,154,156,106,107,48,49,9b2200acd6bd572eea00ea89eeb3b2c0764c8942,Committer [name=Bram Moolenaar; email=Bram@vim.org]
https://github.com/vim/vim,src/edit.c,src/edit.c,6749,6756,381,383,268,269,113,114,433f7c88d56bb8fd99082314055305a656462a13,Committer [name=Bram Moolenaar; email=Bram@vim.org]
https://github.com/vim/vim,src/option.c,src/option.c,8653,8662,925,929,680,682,245,247,fa1d140a2c8865c044d7a83a4f66bb755a6e104a,Committer [name=Bram Moolenaar; email=Bram@vim.org]
https://github.com/vim/vim,src/gui.c,src/gui.c,3769,3771,290,287,229,228,61,59,2e2a2815e5c8274bf2e2d9b383707f1c2eee08bb,Committer [name=Bram Moolenaar; email=Bram@vim.org]
https://github.com/vim/vim,src/regexp.c,src/regexp.c,5484,5499,121,121,80,79,41,42,db552d60ec4613d5537d3ebdcc4130f1591c0589,Committer [name=Bram Moolenaar; email=Bram@vim.org]
https://github.com/vim/vim,src/gui_w48.c,src/gui_w48.c,2633,2660,106,109,92,94,14,15,8424a624ce1c38716deabd47f4da23f1e81614bd,Committer [name=Bram Moolenaar; email=Bram@vim.org]
https://github.com/vim/vim,src/gui.c,src/gui.c,3814,3822,289,292,229,230,60,62,9c102387aff079b513533e93bb2a8109ccc1492c,Committer [name=Bram Moolenaar; email=Bram@vim.org]
https://github.com/vim/vim,src/gui_gtk_x11.c,src/gui_gtk_x11.c,4913,4922,261,261,228,227,33,34,9635157db0d9a4d45abdafa2cb0781cf7e0c7fd6,Committer [name=Bram Moolenaar; email=Bram@vim.org]
https://github.com/vim/vim,src/screen.c,src/screen.c,7114,7134,506,510,330,332,176,178,91170f8ae70cb9a2c15a5d89182f317c18aa0de7,Committer [name=Bram Moolenaar; email=Bram@vim.org]
https://github.com/vim/vim,src/message.c,src/message.c,3336,3335,162,162,89,91,73,71,223b4313c860b0ddeadc8166f11b325b66073cc8,Committer [name=Bram Moolenaar; email=Bram@vim.org]
https://github.com/vim/vim,src/gui_w32.c,src/gui_w32.c,3406,3379,119,119,92,90,27,29,8f2ff9fc869299d29f42d2c05ef0b8a364e55e52,Committer [name=Bram Moolenaar; email=Bram@vim.org]
https://github.com/vim/vim,src/misc2.c,src/misc2.c,4188,4258,216,221,159,160,57,61,60a495f02e7dec1db1776d8344cdd4da6a52a41f,Committer [name=Bram Moolenaar; email=Bram@vim.org]
https://github.com/vim/vim,src/os_unix.c,src/os_unix.c,4782,4795,442,442,360,361,82,81,3d20ca1ad143b900c5f2628442ae8436c2f9673f,Committer [name=Bram Moolenaar; email=Bram@vim.org]
https://github.com/vim/vim,src/ex_cmds2.c,src/ex_cmds2.c,2992,3000,182,184,160,161,22,23,8dd1aa58ad96299425a95a48e2442dd1a039cfbd,Committer [name=Bram Moolenaar; email=Bram@vim.org]
https://github.com/vim/vim,src/os_unix.c,src/os_unix.c,4803,4791,444,444,363,362,81,82,38323e4f4a34b64e19579f4ea104561cc620054c,Committer [name=Bram Moolenaar; email=Bram@vim.org]
https://github.com/vim/vim,src/gui_w32.c,src/gui_w32.c,3400,3405,120,122,91,92,29,30,2c7a763832663d5878ff37a58c81fbe95527084a,Committer [name=Bram Moolenaar; email=Bram@vim.org]
https://github.com/vim/vim,src/gui_w32.c,src/gui_w32.c,3405,3404,122,122,92,93,30,29,060f1f08b3128f60b0f55eebe9818f81bf7e28c8,Committer [name=Bram Moolenaar; email=Bram@vim.org]
https://github.com/vim/vim,src/fileio.c,src/fileio.c,6922,6947,398,402,288,291,110,111,fe1c56d6ae98b5a549475ac7b1ec34c6aec250fd,Committer [name=Bram Moolenaar; email=Bram@vim.org]
https://github.com/vim/vim,src/syntax.c,src/syntax.c,6730,6739,166,164,143,144,23,20,4f68858766b47e31a574a506fe9fafed0e90b672,Committer [name=Bram Moolenaar; email=Bram@vim.org]
https://github.com/vim/vim,src/structs.h,src/structs.h,1439,1460,159,159,100,109,59,50,6ee10162b24109d5b3a0558304c110ffc9dc25b7,Committer [name=Bram Moolenaar; email=Bram@vim.org]
https://github.com/vim/vim,src/window.c,src/window.c,4785,4816,247,247,198,197,49,50,67f7131efa985e51e2fe3f8be9524cc767f7d827,Committer [name=Bram Moolenaar; email=Bram@vim.org]
https://github.com/vim/vim,src/main.c,src/main.c,2819,2836,290,298,256,257,34,41,78e1762c4888f5faf3920f01bcc94d8c1b8adb3a,Committer [name=Bram Moolenaar; email=Bram@vim.org]
https://github.com/vim/vim,src/main.c,src/main.c,2836,2845,298,301,257,258,41,43,02b063139b8aefdf0a958aec9fd221c920aea724,Committer [name=Bram Moolenaar; email=Bram@vim.org]
https://github.com/vim/vim,src/screen.c,src/screen.c,7258,7269,514,519,338,339,176,180,1193636b4512d21b02b5f9cdb5ea68bad90349fc,Committer [name=Bram Moolenaar; email=Bram@vim.org]
https://github.com/vim/vim,src/gui_gtk_x11.c,src/gui_gtk_x11.c,4926,4938,261,261,227,228,34,33,2dd8b521bb07b188bb027481c6acb77bf3ea444e,Committer [name=Bram Moolenaar; email=Bram@vim.org]
https://github.com/vim/vim,src/edit.c,src/edit.c,7162,7183,407,412,284,287,123,125,9b25ffbb2b2210d8a27316ba38ff100713504285,Committer [name=Bram Moolenaar; email=Bram@vim.org]
https://github.com/vim/vim,src/getchar.c,src/getchar.c,3662,3676,164,166,118,119,46,47,ee3f7a51c8a2eadde419971cb5a9e01336752a52,Committer [name=Bram Moolenaar; email=Bram@vim.org]
https://github.com/vim/vim,src/misc1.c,src/misc1.c,6443,6447,247,247,187,185,60,62,2c994e8516496ce153527694a35a3017ff174baa,Committer [name=Bram Moolenaar; email=Bram@vim.org]
https://github.com/vim/vim,src/mbyte.c,src/mbyte.c,4410,4412,151,151,139,138,12,13,6203ff97b715e0112f90587f9ce576ef0e7798bc,Committer [name=Bram Moolenaar; email=Bram@vim.org]
https://github.com/vim/vim,src/normal.c,src/normal.c,6928,6943,422,425,315,316,107,109,1f14d57a487a2b1018cc7cbaa8d7d81c80293274,Committer [name=Bram Moolenaar; email=Bram@vim.org]
https://github.com/vim/vim,src/ex_cmds2.c,src/ex_cmds2.c,3057,3060,188,188,165,166,23,22,f33943efe7d82e61b970a45e2ca6716eebdbb659,Committer [name=Bram Moolenaar; email=Bram@vim.org]
https://github.com/vim/vim,src/ex_getln.c,src/ex_getln.c,4791,4803,214,218,168,170,46,48,91a4e82243198d3c54b51296c532005daf5ccd3b,Committer [name=Bram Moolenaar; email=Bram@vim.org]
https://github.com/vim/vim,src/misc1.c,src/misc1.c,6448,6449,247,247,185,184,62,63,e21877ae759827ce9b4422c55dce33237dd175a4,Committer [name=Bram Moolenaar; email=Bram@vim.org]
https://github.com/vim/vim,src/screen.c,src/screen.c,7287,7306,520,525,340,343,180,182,91a4e82243198d3c54b51296c532005daf5ccd3b,Committer [name=Bram Moolenaar; email=Bram@vim.org]
https://github.com/vim/vim,src/gui_mac.c,src/gui_mac.c,4119,4407,112,127,105,119,7,8,1b60e50bf215df9e066d085cf135e4414c551dcc,Committer [name=Bram Moolenaar; email=Bram@vim.org]
https://github.com/vim/vim,src/ops.c,src/ops.c,4927,4928,238,238,172,173,66,65,81a82093230a5afe14e8efacea3114da32099c6b,Committer [name=Bram Moolenaar; email=Bram@vim.org]
https://github.com/vim/vim,src/os_unix.c,src/os_unix.c,4889,4902,453,456,371,373,82,83,e82080179b24c930003e7fa2f580240c9aedd583,Committer [name=Bram Moolenaar; email=Bram@vim.org]
https://github.com/vim/vim,src/misc1.c,src/misc1.c,6461,6465,247,246,184,182,63,64,176dd1e03c7e5f23e633705da2c8718d3cd320e1,Committer [name=Bram Moolenaar; email=Bram@vim.org]
https://github.com/vim/vim,src/normal.c,src/normal.c,6945,6966,425,428,316,317,109,111,a983fe94738e66b8f6a08244ef6dc45ddf5b622f,Committer [name=Bram Moolenaar; email=Bram@vim.org]
https://github.com/vim/vim,src/buffer.c,src/buffer.c,4251,4284,286,289,226,227,60,62,701f7afcdf5f510090116a6a6fa91ca479c88e06,Committer [name=Bram Moolenaar; email=Bram@vim.org]
https://github.com/vim/vim,src/netbeans.c,src/netbeans.c,2744,2738,76,74,70,69,6,5,fe86f2d7cdb284f18543cac2e6cbbe11352c7f48,Committer [name=Bram Moolenaar; email=Bram@vim.org]
https://github.com/vim/vim,src/fileio.c,src/fileio.c,7080,7094,415,418,302,304,113,114,e0e6f9921283cb3489943c2559753fe24d1c0603,Committer [name=Bram Moolenaar; email=Bram@vim.org]
https://github.com/vim/vim,src/gui_w32.c,src/gui_w32.c,3423,3450,122,124,93,94,29,30,3ca9a8a00d69cf943a09cc7b49e04e1b9a9cefe9,Committer [name=Bram Moolenaar; email=Bram@vim.org]
https://github.com/vim/vim,src/gui_w48.c,src/gui_w48.c,2746,2801,113,118,96,99,17,19,3ca9a8a00d69cf943a09cc7b49e04e1b9a9cefe9,Committer [name=Bram Moolenaar; email=Bram@vim.org]
https://github.com/vim/vim,src/option.c,src/option.c,8792,8811,937,939,689,690,248,249,faff14ae031c3f6a7f8c9aa47d9890bec4e3753d,Committer [name=Bram Moolenaar; email=Bram@vim.org]
https://github.com/vim/vim,src/option.c,src/option.c,8836,8907,942,946,693,696,249,250,28e8d278683dbc632fcb89cfd7f1ca0ac529a5be,Committer [name=Bram Moolenaar; email=Bram@vim.org]
https://github.com/vim/vim,src/screen.c,src/screen.c,7377,7402,536,539,348,350,188,189,2bea291af0fbbdcbcfd7812cf4f294699dfc00b9,Committer [name=Bram Moolenaar; email=Bram@vim.org]
https://github.com/vim/vim,src/eval.c,src/eval.c,17693,17633,522,517,470,466,52,51,798b30bdfd71546ae975df583020dd118936511a,Committer [name=Bram Moolenaar; email=Bram@vim.org]
https://github.com/vim/vim,src/edit.c,src/edit.c,7233,7238,417,419,290,291,127,128,5fd0ca70d31f835eefb1ee8a06b73763d761a134,Committer [name=Bram Moolenaar; email=Bram@vim.org]
https://github.com/vim/vim,src/edit.c,src/edit.c,7229,7233,415,417,289,290,126,127,0ab2a8870cc335acd99f7f4d806f802818d97014,Committer [name=Bram Moolenaar; email=Bram@vim.org]
https://github.com/vim/vim,src/ex_docmd.c,src/ex_docmd.c,8341,8346,382,384,283,284,99,100,5fd0ca70d31f835eefb1ee8a06b73763d761a134,Committer [name=Bram Moolenaar; email=Bram@vim.org]
https://github.com/vim/vim,src/structs.h,src/structs.h,1482,1486,165,167,115,116,50,51,0ab2a8870cc335acd99f7f4d806f802818d97014,Committer [name=Bram Moolenaar; email=Bram@vim.org]
https://github.com/vim/vim,src/edit.c,src/edit.c,7241,7233,420,416,291,289,129,127,8f0b2d46c7020c2ae097c748940f74b3af1383f7,Committer [name=Bram Moolenaar; email=Bram@vim.org]
https://github.com/vim/vim,src/ex_docmd.c,src/ex_docmd.c,8346,8340,384,382,284,283,100,99,8f0b2d46c7020c2ae097c748940f74b3af1383f7,Committer [name=Bram Moolenaar; email=Bram@vim.org]
https://github.com/vim/vim,src/structs.h,src/structs.h,1487,1483,167,165,116,115,51,50,8f0b2d46c7020c2ae097c748940f74b3af1383f7,Committer [name=Bram Moolenaar; email=Bram@vim.org]
https://github.com/vim/vim,src/if_mzsch.c,src/if_mzsch.c,1936,2370,65,85,61,83,4,2,9e70cf192e0957e7e8e1e83f3f9f64822a7a96ee,Committer [name=Bram Moolenaar; email=Bram@vim.org]
https://github.com/vim/vim,src/window.c,src/window.c,4830,4894,248,255,198,204,50,51,746ebd3b6a2ad53dc0caf0872e7895d0cab966e1,Committer [name=Bram Moolenaar; email=Bram@vim.org]
https://github.com/vim/vim,src/eval.c,src/eval.c,17661,17681,517,520,466,468,51,52,da9591ecfd31fab84e9fbca393b198e4de2de880,Committer [name=Bram Moolenaar; email=Bram@vim.org]
https://github.com/vim/vim,src/ops.c,src/ops.c,4962,4948,241,238,176,174,65,64,da9591ecfd31fab84e9fbca393b198e4de2de880,Committer [name=Bram Moolenaar; email=Bram@vim.org]
https://github.com/vim/vim,src/ops.c,src/ops.c,4948,4949,238,238,174,173,64,65,be1138baba7cc49b4ff1da0beb16643eb2747fdb,Committer [name=Bram Moolenaar; email=Bram@vim.org]
https://github.com/vim/vim,src/ex_cmds2.c,src/ex_cmds2.c,3072,3083,189,191,167,168,22,23,6b29b0e809b14e41def8976190d24f0babddd95c,Committer [name=Bram Moolenaar; email=Bram@vim.org]
https://github.com/vim/vim,src/ex_cmds2.c,src/ex_cmds2.c,3087,3087,191,192,168,170,23,22,8d8ef0b0b9c95e117d988fbf9e3bdaa8fef60cc4,Committer [name=Bram Moolenaar; email=Bram@vim.org]
https://github.com/vim/vim,src/getchar.c,src/getchar.c,3720,3743,167,170,120,122,47,48,0dbf720d864782177041d276d78e4a216fd320f9,Committer [name=Bram Moolenaar; email=Bram@vim.org]
https://github.com/vim/vim,src/if_ruby.c,src/if_ruby.c,848,906,34,37,30,34,4,3,3fac56e87e28b89fe89114343fc5cd013823c731,Committer [name=Bram Moolenaar; email=Bram@vim.org]
https://github.com/vim/vim,src/memline.c,src/memline.c,3401,3405,119,119,93,91,26,28,9dbe4758b1c2333c00e554d54767fbca35880201,Committer [name=Bram Moolenaar; email=Bram@vim.org]
https://github.com/vim/vim,src/menu.c,src/menu.c,1897,1979,83,95,70,74,13,21,70b11cdd56a062d19eefb483f549da1578aaea40,Committer [name=Bram Moolenaar; email=Bram@vim.org]
https://github.com/vim/vim,src/blowfish.c,src/blowfish.c,493,493,5,3,5,1,0,2,0bbabe80800bd80b245b6e8b2fff4d3a908c5ded,Committer [name=Bram Moolenaar; email=Bram@vim.org]
https://github.com/vim/vim,src/gui_gtk_x11.c,src/gui_gtk_x11.c,5061,5073,268,271,234,235,34,36,30bb41445cfcc4f34fe1f862064cea01b7a363f6,Committer [name=Bram Moolenaar; email=Bram@vim.org]
https://github.com/vim/vim,src/move.c,src/move.c,2248,2252,196,197,123,122,73,75,64486671c3fcc75698c57732c50865ad0573b3fe,Committer [name=Bram Moolenaar; email=Bram@vim.org]
https://github.com/vim/vim,src/main.c,src/main.c,2909,2925,315,317,270,271,45,46,67c53844343011089e1b847200b5c5257a83e1c4,Committer [name=Bram Moolenaar; email=Bram@vim.org]
https://github.com/vim/vim,src/netbeans.c,src/netbeans.c,2767,2776,81,87,76,85,5,2,67c53844343011089e1b847200b5c5257a83e1c4,Committer [name=Bram Moolenaar; email=Bram@vim.org]
https://github.com/vim/vim,src/undo.c,src/undo.c,2130,2157,64,66,59,60,5,6,a3ff49fdccd518c91c9445ab3e82394b6812bf4a,Committer [name=Bram Moolenaar; email=Bram@vim.org]
https://github.com/vim/vim,src/syntax.c,src/syntax.c,7007,7009,190,190,168,169,22,21,56be950094e10e68da1f901ba971c5f3e9821685,Committer [name=Bram Moolenaar; email=Bram@vim.org]
https://github.com/vim/vim,src/normal.c,src/normal.c,7137,7177,449,457,337,343,112,114,d5b3a2cbd9dcdafd5615bc3275c426864ec9e818,Committer [name=Bram Moolenaar; email=Bram@vim.org]
https://github.com/vim/vim,src/gui_gtk.c,src/gui_gtk.c,2224,1340,102,24,96,22,6,2,182c5be111889643294083c830080cfbaa3dd154,Committer [name=Bram Moolenaar; email=Bram@vim.org]
https://github.com/vim/vim,src/gui_gtk_x11.c,src/gui_gtk_x11.c,5116,4116,274,108,236,94,38,14,182c5be111889643294083c830080cfbaa3dd154,Committer [name=Bram Moolenaar; email=Bram@vim.org]
https://github.com/vim/vim,src/mbyte.c,src/mbyte.c,5222,4504,149,109,136,99,13,10,182c5be111889643294083c830080cfbaa3dd154,Committer [name=Bram Moolenaar; email=Bram@vim.org]
https://github.com/vim/vim,src/gui.c,src/gui.c,3916,3951,304,311,240,244,64,67,b2c0350c67736b0e054718fb5bf136147ee2261e,Committer [name=Bram Moolenaar; email=Bram@vim.org]
https://github.com/vim/vim,src/main.c,src/main.c,2927,2963,316,323,270,274,46,49,b2c0350c67736b0e054718fb5bf136147ee2261e,Committer [name=Bram Moolenaar; email=Bram@vim.org]
https://github.com/vim/vim,src/normal.c,src/normal.c,7177,7040,457,430,343,318,114,112,b2c0350c67736b0e054718fb5bf136147ee2261e,Committer [name=Bram Moolenaar; email=Bram@vim.org]
https://github.com/vim/vim,src/option.c,src/option.c,9162,9260,978,988,726,737,252,251,1a38442dbc01e511c29e19faa2ee9a8527151887,Committer [name=Bram Moolenaar; email=Bram@vim.org]
https://github.com/vim/vim,src/syntax.c,src/syntax.c,7038,7056,190,199,169,173,21,26,61623362bedd22659d4fbf8ea6f55f5c8c5285e8,Committer [name=Bram Moolenaar; email=Bram@vim.org]
https://github.com/vim/vim,src/structs.h,src/structs.h,1536,1542,173,175,125,126,48,49,bd5e15fd5c7e42505d6b0e20f4198d24fc7e219d,Committer [name=Bram Moolenaar; email=Bram@vim.org]
https://github.com/vim/vim,src/option.c,src/option.c,9304,9327,991,997,738,742,253,255,f5963f719eb85e8aa71aeb5c23c4edf4949adef1,Committer [name=Bram Moolenaar; email=Bram@vim.org]
https://github.com/vim/vim,src/eval.c,src/eval.c,18105,18157,548,551,497,499,51,52,7510fe74337599f70ae2044aef4f186b1f1c1bf9,Committer [name=Bram Moolenaar; email=Bram@vim.org]
https://github.com/vim/vim,src/misc1.c,src/misc1.c,6856,6892,252,261,187,191,65,70,bdc975cdfe38521ba6359fa9df1dea5372c53d94,Committer [name=Bram Moolenaar; email=Bram@vim.org]
https://github.com/vim/vim,src/misc1.c,src/misc1.c,6885,6906,257,255,187,188,70,67,31710268ed8557ebcec4130b24550c7790725f73,Committer [name=Bram Moolenaar; email=Bram@vim.org]
https://github.com/vim/vim,src/ex_docmd.c,src/ex_docmd.c,8452,8432,389,387,289,288,100,99,78f74a91bfd29ecd3ff2bb16334535a232300a8c,Committer [name=Bram Moolenaar; email=Bram@vim.org]
https://github.com/vim/vim,src/eval.c,src/eval.c,18189,18207,554,554,501,502,53,52,680eeca955446267680a52cb1207728dc7a2d004,Committer [name=Bram Moolenaar; email=Bram@vim.org]
https://github.com/vim/vim,src/getchar.c,src/getchar.c,3753,3757,171,173,122,123,49,50,b8e86705ca09deeee5044af6e3afb4e9999eceb5,Committer [name=Bram Moolenaar; email=Bram@vim.org]
https://github.com/vim/vim,src/ops.c,src/ops.c,4969,4978,240,240,174,175,66,65,bf9680e441f09a6b90ad3185154474442d363a55,Committer [name=Bram Moolenaar; email=Bram@vim.org]
https://github.com/vim/vim,src/hardcopy.c,src/hardcopy.c,2666,2697,68,71,42,44,26,27,d9462e394a582b2698e13648c95acf22322ee766,Committer [name=Bram Moolenaar; email=Bram@vim.org]
https://github.com/vim/vim,src/getchar.c,src/getchar.c,3758,3764,173,173,123,124,50,49,877b97b9531b70ee05b2c3338354980159e4f67b,Committer [name=Bram Moolenaar; email=Bram@vim.org]
https://github.com/vim/vim,src/ex_docmd.c,src/ex_docmd.c,8481,8494,386,388,287,288,99,100,85de20665f3ed48345b79cd0920af41397544141,Committer [name=Bram Moolenaar; email=Bram@vim.org]
https://github.com/vim/vim,src/ex_cmds.c,src/ex_cmds.c,5507,5486,256,248,187,182,69,66,e60acc180b1886825246d194a2b9ce5d9bb91b2c,Committer [name=Bram Moolenaar; email=Bram@vim.org]
https://github.com/vim/vim,src/ex_docmd.c,src/ex_docmd.c,8494,8484,388,384,288,287,100,97,e60acc180b1886825246d194a2b9ce5d9bb91b2c,Committer [name=Bram Moolenaar; email=Bram@vim.org]
https://github.com/vim/vim,src/fileio.c,src/fileio.c,7574,7530,459,442,338,327,121,115,e60acc180b1886825246d194a2b9ce5d9bb91b2c,Committer [name=Bram Moolenaar; email=Bram@vim.org]
https://github.com/vim/vim,src/option.c,src/option.c,9357,9337,996,990,740,736,256,254,b07269a548ee40bf509f8ce2c19f3a86d37916e5,Committer [name=Bram Moolenaar; email=Bram@vim.org]
https://github.com/vim/vim,src/memline.c,src/memline.c,3740,3717,136,125,107,99,29,26,e60acc180b1886825246d194a2b9ce5d9bb91b2c,Committer [name=Bram Moolenaar; email=Bram@vim.org]
https://github.com/vim/vim,src/os_win32.c,src/os_win32.c,3629,4010,155,166,133,139,22,27,4b9669f1dc0b1f30a378624810ca144b9ca49a8e,Committer [name=Bram Moolenaar; email=Bram@vim.org]
https://github.com/vim/vim,src/message.c,src/message.c,3585,3593,173,173,99,98,74,75,b8bf541f8944a9a0ea0a4b75f8d18a565f5d91d1,Committer [name=Bram Moolenaar; email=Bram@vim.org]
https://github.com/vim/vim,src/ex_cmds.c,src/ex_cmds.c,5496,5554,250,254,183,186,67,68,667b4d2db96fbdb8d19d413138ce45d56bccbe0f,Committer [name=Bram Moolenaar; email=Bram@vim.org]
https://github.com/vim/vim,src/os_unix.c,src/os_unix.c,5214,5247,495,499,410,412,85,87,c842748302d33bcf41c6b796a43d9dbbf44cdc29,Committer [name=Bram Moolenaar; email=Bram@vim.org]
https://github.com/vim/vim,src/ex_getln.c,src/ex_getln.c,4973,5004,227,231,179,182,48,49,db710ed999edf318477ae12d95f66519f2b21bbf,Committer [name=Bram Moolenaar; email=Bram@vim.org]
https://github.com/vim/vim,src/term.c,src/term.c,4240,4287,332,335,271,272,61,63,1dff76bcb88e657556177e653f931129799a863e,Committer [name=Bram Moolenaar; email=Bram@vim.org]
https://github.com/vim/vim,src/main.c,src/main.c,2990,3000,330,329,281,279,49,50,bbc98db7c45ed9c8a6bbc7e2ac7c67180ccbab16,Committer [name=Bram Moolenaar; email=Bram@vim.org]
https://github.com/vim/vim,src/if_tcl.c,src/if_tcl.c,1686,1655,19,23,19,21,0,2,84a4c334e1b840d666d0a178b9e665b6041c6b78,Committer [name=Bram Moolenaar; email=Bram@vim.org]
https://github.com/vim/vim,src/edit.c,src/edit.c,7464,7499,428,432,297,299,131,133,f5876f147abc44914e6f0d572aabb9c1f92c1911,Committer [name=Bram Moolenaar; email=Bram@vim.org]
https://github.com/vim/vim,src/edit.c,src/edit.c,7505,7521,432,435,299,301,133,134,704984ac87979fd20b8ba732df3abd3197814f7f,Committer [name=Bram Moolenaar; email=Bram@vim.org]
https://github.com/vim/vim,src/screen.c,src/screen.c,7792,7794,569,568,370,368,199,200,9a920d8c31bc4d267d8790ba0d83b5774316e08f,Committer [name=Bram Moolenaar; email=Bram@vim.org]
https://github.com/vim/vim,src/window.c,src/window.c,4956,4987,263,268,211,214,52,54,362ce4804819f39d5a4a21923577f3ccc59c8ad5,Committer [name=Bram Moolenaar; email=Bram@vim.org]
https://github.com/vim/vim,src/misc1.c,src/misc1.c,7296,7334,255,258,187,188,68,70,bfe3bf806a8a4300289055643d13d19e2dbc8967,Committer [name=Bram Moolenaar; email=Bram@vim.org]
https://github.com/vim/vim,src/if_py_both.h,src/if_py_both.h,2007,2027,16,24,16,22,0,2,2afa3238a13fe3f4769fa777ada34ec0d1ea5548,Committer [name=Bram Moolenaar; email=Bram@vim.org]
https://github.com/vim/vim,src/ex_cmds.c,src/ex_cmds.c,5599,5621,254,258,186,189,68,69,07e31c571a13855cf67c69f3a676038510141699,Committer [name=Bram Moolenaar; email=Bram@vim.org]
https://github.com/vim/vim,src/os_unix.c,src/os_unix.c,5257,5289,503,506,416,418,87,88,2b9578f0f8cdba144e996273bca586b384e33d90,Committer [name=Bram Moolenaar; email=Bram@vim.org]
https://github.com/vim/vim,src/main.c,src/main.c,3009,3019,330,334,280,283,50,51,8866d277c97632d013c56b12a4bb98701d4a9ae0,Committer [name=Bram Moolenaar; email=Bram@vim.org]
https://github.com/vim/vim,src/ex_docmd.c,src/ex_docmd.c,8628,8638,397,402,295,299,102,103,b2c5a5ac79848b7f889a8b279eed40be3064feca,Committer [name=Bram Moolenaar; email=Bram@vim.org]
https://github.com/vim/vim,src/normal.c,src/normal.c,7246,7252,442,445,328,330,114,115,b2c5a5ac79848b7f889a8b279eed40be3064feca,Committer [name=Bram Moolenaar; email=Bram@vim.org]
https://github.com/vim/vim,src/search.c,src/search.c,4250,4248,152,152,87,88,65,64,187d3acb7fbb82266802db9dc3c659f8b725fbd0,Committer [name=Bram Moolenaar; email=Bram@vim.org]
https://github.com/vim/vim,src/os_mswin.c,src/os_mswin.c,2437,1928,135,118,117,103,18,15,693e40c2cdb65f19febde5664633ac465931cc63,Committer [name=Bram Moolenaar; email=Bram@vim.org]
https://github.com/vim/vim,src/ops.c,src/ops.c,5146,5159,254,254,185,184,69,70,e2e663f67d9f44ae876659bd492f734d48bd2970,Committer [name=Bram Moolenaar; email=Bram@vim.org]
https://github.com/vim/vim,src/ui.c,src/ui.c,2426,2447,139,141,107,108,32,33,1a0316ca2a617c5becc187337c4b9e3f08578d3b,Committer [name=Bram Moolenaar; email=Bram@vim.org]
https://github.com/vim/vim,src/term.c,src/term.c,4349,4401,344,347,272,273,72,74,9584b31aae31d8b031243eab75e26fbaa1755a1f,Committer [name=Bram Moolenaar; email=Bram@vim.org]
https://github.com/vim/vim,src/misc1.c,src/misc1.c,7425,7432,260,260,192,193,68,67,2526ef276b97b1a5275fc0039fb45ca7aa7b6fac,Committer [name=Bram Moolenaar; email=Bram@vim.org]
https://github.com/vim/vim,src/os_unix.c,src/os_unix.c,5332,5374,510,517,422,427,88,90,090cfc1b02d5dcd98ba414ccf56e69cc38f272bd,Committer [name=Bram Moolenaar; email=Bram@vim.org]
https://github.com/vim/vim,src/edit.c,src/edit.c,7556,7570,433,435,296,297,137,138,186628f67153726edf130015e2a8043a5d309c42,Committer [name=Bram Moolenaar; email=Bram@vim.org]
https://github.com/vim/vim,src/fileio.c,src/fileio.c,7597,7587,444,439,329,325,115,114,71afbfe6cd697de30a9e0d57e5a6434cf4bb0f13,Committer [name=Bram Moolenaar; email=Bram@vim.org]
https://github.com/vim/vim,src/misc1.c,src/misc1.c,7434,7437,261,261,193,194,68,67,71afbfe6cd697de30a9e0d57e5a6434cf4bb0f13,Committer [name=Bram Moolenaar; email=Bram@vim.org]
https://github.com/vim/vim,src/if_py_both.h,src/if_py_both.h,2124,2460,19,41,17,37,2,4,4d1da49cfe2528474dafb0535dd0cab19c3c3579,Committer [name=Bram Moolenaar; email=Bram@vim.org]
https://github.com/vim/vim,src/buffer.c,src/buffer.c,4457,4456,308,308,242,241,66,67,567199b68fb5a171c0c006e9d4ac94ca61c5cda0,Committer [name=Bram Moolenaar; email=Bram@vim.org]
https://github.com/vim/vim,src/if_py_both.h,src/if_py_both.h,2676,2725,41,37,36,34,5,3,971db4679940fd2f06733e8a1513215f9e1943a4,Committer [name=Bram Moolenaar; email=Bram@vim.org]
https://github.com/vim/vim,src/regexp_nfa.c,src/regexp_nfa.c,2901,2881,56,56,47,49,9,7,3c577f26cd5d3b8252352d66396e85c4ebe1305d,Committer [name=Bram Moolenaar; email=Bram@vim.org]
https://github.com/vim/vim,src/regexp_nfa.c,src/regexp_nfa.c,3237,3204,65,62,58,56,7,6,51a2983904060e3d69ae31eca99169cd9d7548e9,Committer [name=Bram Moolenaar; email=Bram@vim.org]
https://github.com/vim/vim,src/if_py_both.h,src/if_py_both.h,3629,3765,50,52,46,47,4,5,dd8aca664d9768614d18cebec84badc3ecad3af5,Committer [name=Bram Moolenaar; email=Bram@vim.org]
https://github.com/vim/vim,src/regexp_nfa.c,src/regexp_nfa.c,3492,3489,65,63,59,58,6,5,75d7a069206e8f3805d30f4df4655cb18d022fa4,Committer [name=Bram Moolenaar; email=Bram@vim.org]
https://github.com/vim/vim,src/regexp_nfa.c,src/regexp_nfa.c,3586,3915,65,94,60,85,5,9,efb23f26e8da3edb9fe8c980f7a0f27906f98bf2,Committer [name=Bram Moolenaar; email=Bram@vim.org]
https://github.com/vim/vim,src/regexp.c,src/regexp.c,6202,6205,142,142,99,98,43,44,dacd7de3fd5edd8f3a41ba3c9c389b653b6a9e5d,Committer [name=Bram Moolenaar; email=Bram@vim.org]
https://github.com/vim/vim,src/regexp_nfa.c,src/regexp_nfa.c,4232,4326,109,111,98,101,11,10,e2b8cb3b15c47107c1b05d698ce267ed1ea05079,Committer [name=Bram Moolenaar; email=Bram@vim.org]
https://github.com/vim/vim,src/syntax.c,src/syntax.c,7125,7322,204,217,178,190,26,27,8a7f5a2d4379bdc16502c01456bb4dc5051ed965,Committer [name=Bram Moolenaar; email=Bram@vim.org]
https://github.com/vim/vim,src/regexp_nfa.c,src/regexp_nfa.c,4360,4514,107,111,97,100,10,11,d89616ebb8c0f7c4b96c96f971e2bf9ac944dd44,Committer [name=Bram Moolenaar; email=Bram@vim.org]
https://github.com/vim/vim,src/regexp_nfa.c,src/regexp_nfa.c,4845,5033,120,124,107,109,13,15,e7766eeaa5d92cf727649923cfd3e42b1696df03,Committer [name=Bram Moolenaar; email=Bram@vim.org]
https://github.com/vim/vim,src/regexp_nfa.c,src/regexp_nfa.c,5167,5184,127,127,111,112,16,15,bcf4d178abef9336709b53516fbf0164ce5ebe09,Committer [name=Bram Moolenaar; email=Bram@vim.org]
https://github.com/vim/vim,src/regexp_nfa.c,src/regexp_nfa.c,4728,4845,117,120,106,107,11,13,473de61b0409f8f8c86585733f099f882122b280,Committer [name=Bram Moolenaar; email=Bram@vim.org]
https://github.com/vim/vim,src/os_win32.c,src/os_win32.c,4114,4199,174,176,146,147,28,29,12b559e7c3cba38d53261b925b441f2dffff2368,Committer [name=Bram Moolenaar; email=Bram@vim.org]
https://github.com/vim/vim,src/os_win32.c,src/os_win32.c,4199,4201,176,175,147,145,29,30,03e114b0f2c994d58cd744f9be1b498245bd8c08,Committer [name=Bram Moolenaar; email=Bram@vim.org]
https://github.com/vim/vim,src/eval.c,src/eval.c,18851,18866,577,583,524,529,53,54,8c0e322f18c11f4cc2fb6ee2525d47374044a706,Committer [name=Bram Moolenaar; email=Bram@vim.org]
https://github.com/vim/vim,src/if_py_both.h,src/if_py_both.h,4649,4658,52,52,47,49,5,3,389a1793f40b149ed8553fb75e7ee40bc684d8c5,Committer [name=Bram Moolenaar; email=Bram@vim.org]
https://github.com/vim/vim,src/if_py_both.h,src/if_py_both.h,4822,4826,57,57,51,55,6,2,c1c3d68da9d5a089949e8687b8783daf7ee2d416,Committer [name=Bram Moolenaar; email=Bram@vim.org]
https://github.com/vim/vim,src/mbyte.c,src/mbyte.c,4668,4677,107,110,97,98,10,12,f0327f67c778f46cdf19d793c013f024f01ea818,Committer [name=Bram Moolenaar; email=Bram@vim.org]
https://github.com/vim/vim,src/os_win32.c,src/os_win32.c,4201,4361,175,184,145,151,30,33,27515921196e61034c18718812b6417f65d0337f,Committer [name=Bram Moolenaar; email=Bram@vim.org]
https://github.com/vim/vim,src/misc1.c,src/misc1.c,7453,7489,263,266,196,198,67,68,f4e1143697a2d08eff487dec36128a5e10d5eca8,Committer [name=Bram Moolenaar; email=Bram@vim.org]
https://github.com/vim/vim,src/os_win32.c,src/os_win32.c,4361,4390,184,187,151,153,33,34,4dee1bb0dbcfd4c8aa22533f99603dd337b73ab0,Committer [name=Bram Moolenaar; email=Bram@vim.org]
https://github.com/vim/vim,src/ops.c,src/ops.c,5178,5194,255,259,185,187,70,72,ec11aef914d3f1570c40e9795c145fffaf94edd4,Committer [name=Bram Moolenaar; email=Bram@vim.org]
https://github.com/vim/vim,src/ops.c,src/ops.c,5194,5207,259,259,187,186,72,73,2c019c8696ca56d1a9d1bb10fd1411bad14df0c6,Committer [name=Bram Moolenaar; email=Bram@vim.org]
https://github.com/vim/vim,src/ex_cmds.c,src/ex_cmds.c,5695,5695,260,260,191,192,69,68,631abc35dfc7ad87255c940fd22eee416c731658,Committer [name=Bram Moolenaar; email=Bram@vim.org]
https://github.com/vim/vim,src/buffer.c,src/buffer.c,4499,4515,311,311,244,243,67,68,4c7ab1bb5722de662db04550b74256671f20c4a2,Committer [name=Bram Moolenaar; email=Bram@vim.org]
https://github.com/vim/vim,src/regexp_nfa.c,src/regexp_nfa.c,5659,5683,131,133,114,115,17,18,8df5acfda9e5a41e643066e044f4adb47bfb83ba,Committer [name=Bram Moolenaar; email=Bram@vim.org]
https://github.com/vim/vim,src/term.c,src/term.c,4520,4538,361,364,287,289,74,75,90013c6a751e6574fbe49b529a3dbf1eacbef43d,Committer [name=Bram Moolenaar; email=Bram@vim.org]
https://github.com/vim/vim,src/option.c,src/option.c,9826,9904,1007,1016,747,752,260,264,597a422416f37f8e22ed8f561667d6bab8814958,Committer [name=Bram Moolenaar; email=Bram@vim.org]
https://github.com/vim/vim,src/screen.c,src/screen.c,8020,8056,560,563,367,369,193,194,597a422416f37f8e22ed8f561667d6bab8814958,Committer [name=Bram Moolenaar; email=Bram@vim.org]
https://github.com/vim/vim,src/screen.c,src/screen.c,8057,8119,563,570,369,372,194,198,86b17e914fec6efd3f042090ef9960c35672519c,Committer [name=Bram Moolenaar; email=Bram@vim.org]
https://github.com/vim/vim,src/term.c,src/term.c,4554,4541,366,366,292,290,74,76,4e067c898ef1f4a34cd70ddf3de3a1e60ac23c84,Committer [name=Bram Moolenaar; email=Bram@vim.org]
https://github.com/vim/vim,src/gui_w32.c,src/gui_w32.c,3492,3648,126,135,94,102,32,33,b5a7a8b5451c6fe8a2cc1d5d86c42d9b9a50ef98,Committer [name=Bram Moolenaar; email=Bram@vim.org]
https://github.com/vim/vim,src/option.c,src/option.c,9905,9921,1016,1019,752,753,264,266,b5a7a8b5451c6fe8a2cc1d5d86c42d9b9a50ef98,Committer [name=Bram Moolenaar; email=Bram@vim.org]
https://github.com/vim/vim,src/structs.h,src/structs.h,1663,1672,183,185,131,132,52,53,8f4ac01544b44bdd906d241e4f203de7496e5ac8,Committer [name=Bram Moolenaar; email=Bram@vim.org]
https://github.com/vim/vim,src/eval.c,src/eval.c,19527,19534,586,586,532,531,54,55,5d2bae8b1c2bb8059010ea604e092de9cf3c1baf,Committer [name=Bram Moolenaar; email=Bram@vim.org]
https://github.com/vim/vim,src/os_win32.c,src/os_win32.c,4720,4722,195,195,161,160,34,35,799d6abf3ec600dbb92cdcd5c25985efea053c09,Committer [name=Bram Moolenaar; email=Bram@vim.org]
https://github.com/vim/vim,src/ex_docmd.c,src/ex_docmd.c,8728,8702,406,396,304,303,102,93,958636c40619a9f8c3d10e9f76a7f634dd11d13b,Committer [name=Bram Moolenaar; email=Bram@vim.org]
https://github.com/vim/vim,src/window.c,src/window.c,5393,5387,274,272,227,224,47,48,482a2b5c9d53fa7ae44a64bbbfa0bae868cbe4a0,Committer [name=Bram Moolenaar; email=Bram@vim.org]
https://github.com/vim/vim,src/ex_docmd.c,src/ex_docmd.c,9014,8997,398,402,305,307,93,95,f240e181d720c8a056ad57dfa160b0e8c1371c3a,Committer [name=Bram Moolenaar; email=Bram@vim.org]
https://github.com/vim/vim,src/ex_docmd.c,src/ex_docmd.c,9027,9176,403,405,307,308,96,97,f1d6ccf2f9c8a8ae2c0ec4577946397c103ead2b,Committer [name=Bram Moolenaar; email=Bram@vim.org]
https://github.com/vim/vim,src/fileio.c,src/fileio.c,7639,7566,447,439,333,327,114,112,49a6ed8a8a5fa471bf99f8d068e7cb994c2af163,Committer [name=Bram Moolenaar; email=Bram@vim.org]
https://github.com/vim/vim,src/ex_docmd.c,src/ex_docmd.c,9186,9188,405,404,308,309,97,95,84c8e5ab9cfb6826e880e8ae062ff3347bb6909e,Committer [name=Bram Moolenaar; email=Bram@vim.org]
https://github.com/vim/vim,src/screen.c,src/screen.c,8201,8208,578,581,380,384,198,197,76feaf1bfed170d2fc5c34e7e758885554ecc794,Committer [name=Bram Moolenaar; email=Bram@vim.org]
https://github.com/vim/vim,src/edit.c,src/edit.c,7603,7622,429,432,293,295,136,137,310f2d59b2b20c642088feb5e6dfe323cc570923,Committer [name=Bram Moolenaar; email=Bram@vim.org]
https://github.com/vim/vim,src/if_ruby.c,src/if_ruby.c,1112,1120,80,84,77,79,3,5,bbc1a592a0e0efd5101a58032e7e7cc9f3e9f417,Committer [name=Bram Moolenaar; email=Bram@vim.org]
https://github.com/vim/vim,src/normal.c,src/normal.c,7213,7232,357,357,282,281,75,76,3a304b23823b089e499063e8211c5695d049f3ba,Committer [name=Bram Moolenaar; email=Bram@vim.org]
https://github.com/vim/vim,src/term.c,src/term.c,4565,4615,366,368,290,291,76,77,b5c3265521749fda81ae4b052de35a0d1209cf50,Committer [name=Bram Moolenaar; email=Bram@vim.org]
https://github.com/vim/vim,src/os_win32.c,src/os_win32.c,4732,4756,189,188,154,151,35,37,ac360bf2ca293735fc7c6654dc2b3066f4c62488,Committer [name=Bram Moolenaar; email=Bram@vim.org]
https://github.com/vim/vim,src/move.c,src/move.c,2300,2276,206,195,130,121,76,74,43335ea394fe247132b9701c55cccf51e6c36425,Committer [name=Bram Moolenaar; email=Bram@vim.org]
https://github.com/vim/vim,src/eval.c,src/eval.c,19922,19937,589,592,533,535,56,57,ba117c23dfd1146aca3235bea172df17a48bccee,Committer [name=Bram Moolenaar; email=Bram@vim.org]
https://github.com/vim/vim,src/term.c,src/term.c,4637,4629,370,367,293,292,77,75,0379d01c52e7930ccfc9133f229fba54a2024a42,Committer [name=Bram Moolenaar; email=Bram@vim.org]
https://github.com/vim/vim,src/os_unix.c,src/os_unix.c,5511,5448,522,505,430,419,92,86,e7fedb6ebe72d9a475aa65109b77d5ed4667067a,Committer [name=Bram Moolenaar; email=Bram@vim.org]
https://github.com/vim/vim,src/ops.c,src/ops.c,5522,5522,205,207,149,150,56,57,c71982b23978ef61d0a2f0fe5535e782e1c561ed,Committer [name=Bram Moolenaar; email=Bram@vim.org]
https://github.com/vim/vim,src/ex_cmds.c,src/ex_cmds.c,5863,5906,267,273,198,203,69,70,f7edf40448a09e04eec3bd05e043f7fea93b07c9,Committer [name=Bram Moolenaar; email=Bram@vim.org]
https://github.com/vim/vim,src/eval.c,src/eval.c,20409,20409,601,601,544,540,57,61,48e697e4b6b6b490c58ec9393da9b2d2ea47c6d8,Committer [name=Bram Moolenaar; email=Bram@vim.org]
https://github.com/vim/vim,src/channel.c,src/channel.c,128,537,5,37,4,37,1,0,d04a020a8a8d7a438b091d49218c438880beb50c,Committer [name=Bram Moolenaar; email=Bram@vim.org]
https://github.com/vim/vim,src/ex_getln.c,src/ex_getln.c,5153,5153,244,244,192,191,52,53,d25c16e2f2776d50245bf31d6e4d5364f12d188e,Committer [name=Bram Moolenaar; email=Bram@vim.org]
https://github.com/vim/vim,src/ex_cmds.c,src/ex_cmds.c,5908,5908,273,273,203,201,70,72,f28dbcea371b3a35727d91afc90fb90e0527d78a,Committer [name=Bram Moolenaar; email=Bram@vim.org]
https://github.com/vim/vim,src/ex_docmd.c,src/ex_docmd.c,9282,9282,414,414,318,319,96,95,f28dbcea371b3a35727d91afc90fb90e0527d78a,Committer [name=Bram Moolenaar; email=Bram@vim.org]
https://github.com/vim/vim,src/message.c,src/message.c,3635,3522,175,141,99,78,76,63,92b8b2d307e34117f146319872010b0ccc9d2713,Committer [name=Bram Moolenaar; email=Bram@vim.org]
https://github.com/vim/vim,src/misc2.c,src/misc2.c,4635,4635,247,247,187,186,60,61,92b8b2d307e34117f146319872010b0ccc9d2713,Committer [name=Bram Moolenaar; email=Bram@vim.org]
https://github.com/vim/vim,src/normal.c,src/normal.c,7262,7262,357,357,282,281,75,76,92b8b2d307e34117f146319872010b0ccc9d2713,Committer [name=Bram Moolenaar; email=Bram@vim.org]
https://github.com/vim/vim,src/spell.c,src/spell.c,11565,11565,183,183,113,111,70,72,baaa7e9ec7398a813e21285c272fa99792642077,Committer [name=Bram Moolenaar; email=Bram@vim.org]
https://github.com/vim/vim,src/proto.h,src/proto.h,146,146,19,19,19,15,0,4,d99df423c559d85c17779b3685426c489554908c,Committer [name=Bram Moolenaar; email=Bram@vim.org]
https://github.com/vim/vim,src/getchar.c,src/getchar.c,3853,3839,175,169,124,120,51,49,e2c3810c2ae290bbc2cba18eb47cc2d44e4b9797,Committer [name=Bram Moolenaar; email=Bram@vim.org]
https://github.com/vim/vim,src/channel.c,src/channel.c,978,1076,38,43,38,41,0,2,4d919d748e4e435edb135aa5ccf6ee7de9212023,Committer [name=Bram Moolenaar; email=Bram@vim.org]
https://github.com/vim/vim,src/channel.c,src/channel.c,1096,1367,43,54,41,48,2,6,6463ca229cb9412581419497924c85fcbfc854ab,Committer [name=Bram Moolenaar; email=Bram@vim.org]
https://github.com/vim/vim,src/channel.c,src/channel.c,1391,1395,57,65,51,48,6,17,7b3ca76a451b10d238ef946f3231762e0bd988e9,Committer [name=Bram Moolenaar; email=Bram@vim.org]
https://github.com/vim/vim,src/channel.c,src/channel.c,1395,1394,65,65,48,47,17,18,16eb4f88000cfdba68df6c421fe44e7e029ba53e,Committer [name=Bram Moolenaar; email=Bram@vim.org]
https://github.com/vim/vim,src/os_win32.c,src/os_win32.c,5053,5041,0,210,0,172,0,38,7d63f624603ebeae336d4c504f82ab3da3481f46,Committer [name=Bram Moolenaar; email=Bram@vim.org]
https://github.com/vim/vim,src/channel.c,src/channel.c,1528,1557,67,71,49,51,18,20,e74e8e7d758e9312165a931f176185f07a64231a,Committer [name=Bram Moolenaar; email=Bram@vim.org]
https://github.com/vim/vim,src/os_win32.c,src/os_win32.c,5037,5053,208,0,170,0,38,0,418f81b5fa400ed59793384f2f3d9df45390f080,Committer [name=Bram Moolenaar; email=Bram@vim.org]
https://github.com/vim/vim,src/channel.c,src/channel.c,1557,1578,71,79,51,57,20,22,81661fb86801e6d6e5194b43dfd27d73fcc016ec,Committer [name=Bram Moolenaar; email=Bram@vim.org]
https://github.com/vim/vim,src/channel.c,src/channel.c,1590,1645,83,87,56,58,27,29,42d38a2db17e70312d073095257555c27a5f9443,Committer [name=Bram Moolenaar; email=Bram@vim.org]
https://github.com/vim/vim,src/gui.c,src/gui.c,4022,4016,316,314,252,251,64,63,cf7164a088664961e7d70dd100c5874dc5ceb293,Committer [name=Bram Moolenaar; email=Bram@vim.org]
https://github.com/vim/vim,src/gui_w32.c,src/gui_w32.c,3639,6539,140,254,107,207,33,47,cf7164a088664961e7d70dd100c5874dc5ceb293,Committer [name=Bram Moolenaar; email=Bram@vim.org]
https://github.com/vim/vim,src/os_mswin.c,src/os_mswin.c,2195,2129,135,112,120,99,15,13,cf7164a088664961e7d70dd100c5874dc5ceb293,Committer [name=Bram Moolenaar; email=Bram@vim.org]
https://github.com/vim/vim,src/channel.c,src/channel.c,1723,1751,87,93,58,63,29,30,9892189d2e7ab94b750f99e6da4cbfc3c8014517,Committer [name=Bram Moolenaar; email=Bram@vim.org]
https://github.com/vim/vim,src/popupmnu.c,src/popupmnu.c,554,560,14,17,3,5,11,12,0106e3d0bf8a38351af45331cbf3b9172a6bb90b,Committer [name=Bram Moolenaar; email=Bram@vim.org]
https://github.com/vim/vim,src/channel.c,src/channel.c,1751,1714,93,82,63,54,30,28,9186a276222ea8a7c88f4092ac5b4201381f4e20,Committer [name=Bram Moolenaar; email=Bram@vim.org]
https://github.com/vim/vim,src/gui_beval.c,src/gui_beval.c,981,1129,45,86,45,83,0,3,9892189d2e7ab94b750f99e6da4cbfc3c8014517,Committer [name=Bram Moolenaar; email=Bram@vim.org]
https://github.com/vim/vim,src/gui_gtk.c,src/gui_gtk.c,1438,2053,30,211,28,185,2,26,9892189d2e7ab94b750f99e6da4cbfc3c8014517,Committer [name=Bram Moolenaar; email=Bram@vim.org]
https://github.com/vim/vim,src/gui_gtk_f.c,src/gui_gtk_f.c,603,953,0,113,0,88,0,25,9892189d2e7ab94b750f99e6da4cbfc3c8014517,Committer [name=Bram Moolenaar; email=Bram@vim.org]
https://github.com/vim/vim,src/json.c,src/json.c,661,702,8,11,6,7,2,4,f1b6ac72293e658bb6e68c5cfd926c405b1b6f34,Committer [name=Bram Moolenaar; email=Bram@vim.org]
https://github.com/vim/vim,src/gui_gtk_x11.c,src/gui_gtk_x11.c,4131,5334,112,249,98,210,14,39,9892189d2e7ab94b750f99e6da4cbfc3c8014517,Committer [name=Bram Moolenaar; email=Bram@vim.org]
https://github.com/vim/vim,src/netbeans.c,src/netbeans.c,2555,2595,49,57,47,54,2,3,9892189d2e7ab94b750f99e6da4cbfc3c8014517,Committer [name=Bram Moolenaar; email=Bram@vim.org]
https://github.com/vim/vim,src/json.c,src/json.c,764,760,23,20,19,15,4,5,b36287283781e09d8874157b9d9bdc5243a2f319,Committer [name=Bram Moolenaar; email=Bram@vim.org]
https://github.com/vim/vim,src/channel.c,src/channel.c,1857,1855,85,80,57,55,28,25,d42119fff228434fe57e88d501c744de0a9fb1b1,Committer [name=Bram Moolenaar; email=Bram@vim.org]
https://github.com/vim/vim,src/channel.c,src/channel.c,1855,1876,80,83,55,57,25,26,fdd6ce4a2f922afac7bd719a00228dbd8539b9c4,Committer [name=Bram Moolenaar; email=Bram@vim.org]
https://github.com/vim/vim,src/channel.c,src/channel.c,1876,1882,83,86,57,58,26,28,e081e21f760bffc24ca98d5f9bbdb5f02e6aea79,Committer [name=Bram Moolenaar; email=Bram@vim.org]
https://github.com/vim/vim,src/edit.c,src/edit.c,7653,7659,432,435,295,297,137,138,d1413d90983fc6c579ad66ba4d4611b057197f94,Committer [name=Bram Moolenaar; email=Bram@vim.org]
https://github.com/vim/vim,src/main.c,src/main.c,3063,3070,340,343,290,292,50,51,d1413d90983fc6c579ad66ba4d4611b057197f94,Committer [name=Bram Moolenaar; email=Bram@vim.org]
https://github.com/vim/vim,src/os_unix.c,src/os_unix.c,5511,5507,519,517,432,431,87,86,802d559431e6003a46c7f19628213b7cec8ba6d0,Committer [name=Bram Moolenaar; email=Bram@vim.org]
https://github.com/vim/vim,src/channel.c,src/channel.c,2056,2058,86,88,58,61,28,27,045a284a83c2a85113de233d5233eae34724a4b6,Committer [name=Bram Moolenaar; email=Bram@vim.org]
https://github.com/vim/vim,src/channel.c,src/channel.c,2100,2032,91,60,64,53,27,7,509ce2a558e7e0c03242e32e844255af52f1c821,Committer [name=Bram Moolenaar; email=Bram@vim.org]
https://github.com/vim/vim,src/eval.c,src/eval.c,20929,20901,653,639,591,578,62,61,509ce2a558e7e0c03242e32e844255af52f1c821,Committer [name=Bram Moolenaar; email=Bram@vim.org]
https://github.com/vim/vim,src/ex_cmds.c,src/ex_cmds.c,5854,5858,268,268,196,195,72,73,927030af23982a70580178e32806cd3638ce6e5b,Committer [name=Bram Moolenaar; email=Bram@vim.org]
https://github.com/vim/vim,src/ex_getln.c,src/ex_getln.c,5159,5165,242,244,190,191,52,53,064154c3fedd6a46ca2f61463d7e5567bd22d9f1,Committer [name=Bram Moolenaar; email=Bram@vim.org]
https://github.com/vim/vim,src/main.c,src/main.c,3073,3074,344,344,293,292,51,52,baec5c1768098f9dd867b465aaabfdfb294f10c2,Committer [name=Bram Moolenaar; email=Bram@vim.org]
https://github.com/vim/vim,src/eval.c,src/eval.c,20635,20719,627,629,567,568,60,61,107e1eef1df3b786ad3ad49fbdb9e058649303b5,Committer [name=Bram Moolenaar; email=Bram@vim.org]
https://github.com/vim/vim,src/option.c,src/option.c,10096,10116,1016,1020,744,743,272,277,8a633e3427b47286869aa4b96f2bfc1fe65b25cd,Committer [name=Bram Moolenaar; email=Bram@vim.org]
https://github.com/vim/vim,src/screen.c,src/screen.c,8221,8275,582,592,383,385,199,207,8a633e3427b47286869aa4b96f2bfc1fe65b25cd,Committer [name=Bram Moolenaar; email=Bram@vim.org]
https://github.com/vim/vim,src/syntax.c,src/syntax.c,7320,7443,218,253,191,207,27,46,8a633e3427b47286869aa4b96f2bfc1fe65b25cd,Committer [name=Bram Moolenaar; email=Bram@vim.org]
https://github.com/vim/vim,src/fileio.c,src/fileio.c,7506,7506,430,430,325,327,105,103,827b165b2aebad2cfe98cc6d5804c6c0fe8afd89,Committer [name=Bram Moolenaar; email=Bram@vim.org]
https://github.com/vim/vim,src/tag.c,src/tag.c,2952,2953,173,173,109,110,64,63,827b165b2aebad2cfe98cc6d5804c6c0fe8afd89,Committer [name=Bram Moolenaar; email=Bram@vim.org]
https://github.com/vim/vim,src/term.c,src/term.c,4623,4623,359,359,284,286,75,73,827b165b2aebad2cfe98cc6d5804c6c0fe8afd89,Committer [name=Bram Moolenaar; email=Bram@vim.org]
https://github.com/vim/vim,src/syntax.c,src/syntax.c,7437,7435,251,249,207,209,44,40,d80629cef03cd40b0bf06c402dfe0b720b3bf608,Committer [name=Bram Moolenaar; email=Bram@vim.org]
https://github.com/vim/vim,src/os_unix.c,src/os_unix.c,5660,5670,514,518,430,432,84,86,e30a3d01dc1b6b066748b1d61cced05cf92b3c80,Committer [name=Bram Moolenaar; email=Bram@vim.org]
https://github.com/vim/vim,src/os_unix.c,src/os_unix.c,5640,5660,514,514,428,430,86,84,cda7764d8e65325d4524e5d6c3174121eeb12cad,Committer [name=Bram Moolenaar; email=Bram@vim.org]
https://github.com/vim/vim,src/ex_cmds.c,src/ex_cmds.c,5865,6084,267,266,194,192,73,74,45d2eeaad66939348893b9254171067b0457cd9d,Committer [name=Bram Moolenaar; email=Bram@vim.org]
https://github.com/vim/vim,src/ex_getln.c,src/ex_getln.c,5285,5357,246,248,193,194,53,54,1fd99c1ca89a3d13bb53aff4a5a8f5ee740713e5,Committer [name=Bram Moolenaar; email=Bram@vim.org]
https://github.com/vim/vim,src/ex_cmds.c,src/ex_cmds.c,6084,6108,266,269,192,194,74,75,012270936c3c7df3bba45ad2b48938c23a2fd43a,Committer [name=Bram Moolenaar; email=Bram@vim.org]
https://github.com/vim/vim,src/ops.c,src/ops.c,5613,5665,211,221,154,159,57,62,ad5ca9bc1e7145474adb082775a805f1731e9e37,Committer [name=Bram Moolenaar; email=Bram@vim.org]
https://github.com/vim/vim,src/fileio.c,src/fileio.c,7527,7511,434,428,331,327,103,101,bde9810d6103ffe3a22a9330021cb21db1ed1792,Committer [name=Bram Moolenaar; email=Bram@vim.org]
https://github.com/vim/vim,src/message.c,src/message.c,3475,3528,141,154,78,89,63,65,22fcfad29276bd5f317faf516637dcd491b96a12,Committer [name=Bram Moolenaar; email=Bram@vim.org]
https://github.com/vim/vim,src/buffer.c,src/buffer.c,4512,4515,310,310,243,244,67,66,8240433f48f7383c281ba2453cc55f10b8ec47d9,Committer [name=Bram Moolenaar; email=Bram@vim.org]
https://github.com/vim/vim,src/buffer.c,src/buffer.c,4515,4560,310,316,244,249,66,67,b25f9a97e9aad3cbb4bc3fe87cdbd5700f8aa0c6,Committer [name=Bram Moolenaar; email=Bram@vim.org]
https://github.com/vim/vim,src/eval.c,src/eval.c,20236,17686,655,630,593,574,62,56,a9b579f3d7463720a316e11e77a7a9fbb9267986,Committer [name=Bram Moolenaar; email=Bram@vim.org]
https://github.com/vim/vim,src/os_unix.c,src/os_unix.c,5662,5526,514,495,433,415,81,80,a06ecab7a5159e744448ace731036f0dc5f87dd4,Committer [name=Bram Moolenaar; email=Bram@vim.org]
https://github.com/vim/vim,src/eval.c,src/eval.c,17686,7649,630,131,574,108,56,23,73dad1e64cb42842d8259cb1a255a6fa59822f76,Committer [name=Bram Moolenaar; email=Bram@vim.org]
https://github.com/vim/vim,src/spell.c,src/spell.c,11372,6476,184,125,112,71,72,54,9ccfebddc3ff2a3c2853cf706fd4c26f639bf381,Committer [name=Bram Moolenaar; email=Bram@vim.org]
https://github.com/vim/vim,src/main.c,src/main.c,3033,3035,337,337,285,284,52,53,8c08b5b569e2a9e9f63dea514591ecfa2d3bb392,Committer [name=Bram Moolenaar; email=Bram@vim.org]
https://github.com/vim/vim,src/buffer.c,src/buffer.c,4585,4625,315,320,248,251,67,69,f71d7b9ee5ceba75f70c30845332ddd728fd16c6,Committer [name=Bram Moolenaar; email=Bram@vim.org]
https://github.com/vim/vim,src/vimrun.c,src/vimrun.c,76,55,12,0,11,0,1,0,bcc1dcc981dfc092587d4fbd1327d82a03426c57,Committer [name=Bram Moolenaar; email=Bram@vim.org]
https://github.com/vim/vim,src/option.c,src/option.c,10121,10168,1017,1027,740,748,277,279,95ec9d6a6ab3117d60ff638670a803d43974ba51,Committer [name=Bram Moolenaar; email=Bram@vim.org]
https://github.com/vim/vim,src/option.c,src/option.c,10197,10210,1028,1031,749,751,279,280,920694c1b60fac8017b8909efcc24f189804a9bb,Committer [name=Bram Moolenaar; email=Bram@vim.org]
https://github.com/vim/vim,src/ex_cmds.c,src/ex_cmds.c,6311,6307,278,276,203,202,75,74,78c7e274f27c68bf86b0a68411b128c6945d1f6a,Committer [name=Bram Moolenaar; email=Bram@vim.org]
https://github.com/vim/vim,src/ex_getln.c,src/ex_getln.c,5352,5454,246,253,192,198,54,55,4d6f32cbfbaf324ac4a25c0206a5db0e9f7a48f7,Committer [name=Bram Moolenaar; email=Bram@vim.org]
https://github.com/vim/vim,src/ex_getln.c,src/ex_getln.c,5455,5456,253,253,198,199,55,54,1195669f9e434fa9ab8b57ee9470bf951e4990b8,Committer [name=Bram Moolenaar; email=Bram@vim.org]
https://github.com/vim/vim,src/ex_getln.c,src/ex_getln.c,5456,5460,253,253,199,200,54,53,5a49789a9b1f6447aeafbbbdd5b235dd10c471d5,Committer [name=Bram Moolenaar; email=Bram@vim.org]
https://github.com/vim/vim,src/ex_docmd.c,src/ex_docmd.c,9213,9222,409,411,317,318,92,93,b9c31e71f5a4653a27e81c21226039bfa35b9131,Committer [name=Bram Moolenaar; email=Bram@vim.org]
https://github.com/vim/vim,src/gui_w32.c,src/gui_w32.c,6429,6227,253,239,206,193,47,46,cea912af725c54f4727a0565e31661f6b29c6bb1,Committer [name=Bram Moolenaar; email=Bram@vim.org]
https://github.com/vim/vim,src/os_mswin.c,src/os_mswin.c,2184,2132,117,103,104,93,13,10,cea912af725c54f4727a0565e31661f6b29c6bb1,Committer [name=Bram Moolenaar; email=Bram@vim.org]
https://github.com/vim/vim,src/os_win32.c,src/os_win32.c,5121,4852,205,188,166,153,39,35,cea912af725c54f4727a0565e31661f6b29c6bb1,Committer [name=Bram Moolenaar; email=Bram@vim.org]
https://github.com/vim/vim,src/buffer.c,src/buffer.c,4671,4672,327,327,256,255,71,72,3a117e19e02bf29cfc5e398470dd7851ae3d6803,Committer [name=Bram Moolenaar; email=Bram@vim.org]
https://github.com/vim/vim,src/channel.c,src/channel.c,3924,3932,90,92,83,84,7,8,833eb1d752426689051bf2001083359899536939,Committer [name=Bram Moolenaar; email=Bram@vim.org]
https://github.com/vim/vim,src/edit.c,src/edit.c,7783,7782,438,438,297,296,141,142,ddf662a1c86ef0b4bd0c55c5f0aa192ebd6d9a5e,Committer [name=Bram Moolenaar; email=Bram@vim.org]
https://github.com/vim/vim,src/os_win32.c,src/os_win32.c,5010,5055,189,192,153,155,36,37,7c23d1d9d9cc1d3d19fe35708da7c5d5b3556e05,Committer [name=Bram Moolenaar; email=Bram@vim.org]
https://github.com/vim/vim,src/option.c,src/option.c,10340,10354,1035,1039,756,754,279,285,c43a8b8de0676caf8a460b6af1310d7aba8221bb,Committer [name=Bram Moolenaar; email=Bram@vim.org]
https://github.com/vim/vim,src/option.c,src/option.c,10354,10450,1039,1070,754,743,285,327,a713ff819d134dc34e507c05273c935bfc17e795,Committer [name=Bram Moolenaar; email=Bram@vim.org]
https://github.com/vim/vim,src/main.c,src/main.c,3037,3057,338,342,287,289,51,53,08cab9608781c975b4acbad875862b842b29258d,Committer [name=Bram Moolenaar; email=Bram@vim.org]
https://github.com/vim/vim,src/main.c,src/main.c,3057,3067,342,345,289,294,53,51,436631969716e056feca47480976100b70283370,Committer [name=Bram Moolenaar; email=Bram@vim.org]
https://github.com/vim/vim,src/option.c,src/option.c,10450,10480,1070,1077,743,748,327,329,2c7292dc5bbf155fe2192d417363b8c085759cad,Committer [name=Bram Moolenaar; email=Bram@vim.org]
https://github.com/vim/vim,src/main.c,src/main.c,3073,3079,0,346,0,295,0,51,47ffb905f363571072faefbd417938e7ff351a9f,Committer [name=Bram Moolenaar; email=Bram@vim.org]
https://github.com/vim/vim,src/main.c,src/main.c,3068,3073,344,0,293,0,51,0,b5aedf3e228d35821591da9ae8501b61cf2e264c,Committer [name=Bram Moolenaar; email=Bram@vim.org]
https://github.com/vim/vim,src/screen.c,src/screen.c,8326,8329,596,596,386,385,210,211,c6cd8409c2993b1476e123fba11cb4b8d743b896,Committer [name=Bram Moolenaar; email=Bram@vim.org]
https://github.com/vim/vim,src/term.c,src/term.c,4644,4698,356,354,283,284,73,70,ba6ec182973af726ce9b7b7eb3753fc3a7ae7d1b,Committer [name=Bram Moolenaar; email=Bram@vim.org]
https://github.com/vim/vim,src/gui_gtk_f.c,src/gui_gtk_f.c,845,820,103,96,78,72,25,24,59053e1d9f41f9afa16ac7e266ee825a2eb2dd59,Committer [name=Bram Moolenaar; email=Bram@vim.org]
https://github.com/vim/vim,src/undo.c,src/undo.c,2612,2615,79,79,73,72,6,7,56f2db562ddc6c69026d55360f0cfaacd8adc26a,Committer [name=Bram Moolenaar; email=Bram@vim.org]
https://github.com/vim/vim,src/screen.c,src/screen.c,8379,8419,597,608,386,391,211,217,06f1ed2f78c5c03af95054fc3a8665df39dec362,Committer [name=Bram Moolenaar; email=Bram@vim.org]
https://github.com/vim/vim,src/syntax.c,src/syntax.c,7528,7555,252,260,212,217,40,43,06f1ed2f78c5c03af95054fc3a8665df39dec362,Committer [name=Bram Moolenaar; email=Bram@vim.org]
https://github.com/vim/vim,src/main.c,src/main.c,3117,3124,345,345,294,292,51,53,07ecfa64a18609a986f21d6132d04ee8934f3200,Committer [name=Bram Moolenaar; email=Bram@vim.org]
https://github.com/vim/vim,src/quickfix.c,src/quickfix.c,4203,4210,86,86,83,84,3,2,86f100dc0922e83bead7bcd5fd2bb2abbf153f46,Committer [name=Bram Moolenaar; email=Bram@vim.org]
https://github.com/vim/vim,src/screen.c,src/screen.c,8412,8418,608,610,391,392,217,218,85dad2c815aaef69aa948fb17874b3825dd72def,Committer [name=Bram Moolenaar; email=Bram@vim.org]
https://github.com/vim/vim,src/buffer.c,src/buffer.c,4703,4707,330,328,258,255,72,73,1f2903c43109b16594d141a730659317b15f388d,Committer [name=Bram Moolenaar; email=Bram@vim.org]
https://github.com/vim/vim,src/option.c,src/option.c,10552,10528,1089,1078,753,746,336,332,1f2903c43109b16594d141a730659317b15f388d,Committer [name=Bram Moolenaar; email=Bram@vim.org]
https://github.com/vim/vim,src/buffer.c,src/buffer.c,4707,4715,328,330,255,256,73,74,2155441460a6dc0a72125f7860507693112a1460,Committer [name=Bram Moolenaar; email=Bram@vim.org]
https://github.com/vim/vim,src/main.c,src/main.c,3141,3144,346,346,293,292,53,54,423802d1a282df35078539970eabf559186e1ec8,Committer [name=Bram Moolenaar; email=Bram@vim.org]
https://github.com/vim/vim,src/terminal.c,src/terminal.c,1748,1755,20,22,18,19,2,3,fae428354213b54626ff9e29faa5fd86161da942,Committer [name=Bram Moolenaar; email=Bram@vim.org]
https://github.com/vim/vim,src/terminal.c,src/terminal.c,1757,1757,22,22,19,20,3,2,d8dc1799377027be622d8571545658b20042e92e,Committer [name=Bram Moolenaar; email=Bram@vim.org]
https://github.com/vim/vim,src/undo.c,src/undo.c,2618,2615,80,79,73,74,7,5,eb44a68b42eda207a5bc4def9ea8fc4d38acb650,Committer [name=Bram Moolenaar; email=Bram@vim.org]
https://github.com/vim/vim,src/gui.c,src/gui.c,4044,4060,313,316,251,252,62,64,3d9bdfebf1a8c1eec1c3e1cff6fbb60b3d98f02a,Committer [name=Bram Moolenaar; email=Bram@vim.org]
https://github.com/vim/vim,src/os_unix.c,src/os_unix.c,5737,5762,517,517,435,439,82,78,4f44b886840a90a50575204bc29f72ef309cfaf6,Committer [name=Bram Moolenaar; email=Bram@vim.org]
https://github.com/vim/vim,src/option.c,src/option.c,10549,10563,1080,1084,748,750,332,334,9e13aa7729486d79a530ecae1a7a95d10da27d61,Committer [name=Bram Moolenaar; email=Bram@vim.org]
https://github.com/vim/vim,src/channel.c,src/channel.c,4328,4324,93,94,82,84,11,10,f66a2cda2c425c441fc5e20c8f8893c9630e3aaa,Committer [name=Bram Moolenaar; email=Bram@vim.org]
https://github.com/vim/vim,src/terminal.c,src/terminal.c,2344,2392,28,30,26,25,2,5,740c433c5909e3118dc4a7c42028f8a8b78a353b,Committer [name=Bram Moolenaar; email=Bram@vim.org]
https://github.com/vim/vim,src/terminal.c,src/terminal.c,2396,2390,32,29,27,26,5,3,ec0e07a32484ab70f1c7668294c3d8d67f8aca82,Committer [name=Bram Moolenaar; email=Bram@vim.org]
https://github.com/vim/vim,src/term.c,src/term.c,4864,4872,364,367,295,296,69,71,833e0e3c8ccd6047dd596c4ffd68cb0ab13b4e41,Committer [name=Bram Moolenaar; email=Bram@vim.org]
https://github.com/vim/vim,src/channel.c,src/channel.c,4320,4330,94,94,84,83,10,11,13ebb03e7520c2c34f93444b0146640ca08e7424,Committer [name=Bram Moolenaar; email=Bram@vim.org]
https://github.com/vim/vim,src/gui_gtk_x11.c,src/gui_gtk_x11.c,5392,5360,260,243,221,211,39,32,4ab7968aa9d8a624cd56f55b5cad2bedb240eb73,Committer [name=Bram Moolenaar; email=Bram@vim.org]
https://github.com/vim/vim,src/term.c,src/term.c,4922,4930,369,371,298,302,71,69,f3af54eeb1575618b866aa837e7aca7665aca196,Committer [name=Bram Moolenaar; email=Bram@vim.org]
https://github.com/vim/vim,src/option.c,src/option.c,10566,10582,1083,1086,749,750,334,336,5c6dbcb03fa552d7b0e61c8fcf425147eb6bf7d5,Committer [name=Bram Moolenaar; email=Bram@vim.org]
https://github.com/vim/vim,src/diff.c,src/diff.c,1987,2026,48,51,40,42,8,9,da22b8cc8b1b96fabd5a4c35c57b04a351340fb1,Committer [name=Bram Moolenaar; email=Bram@vim.org]
https://github.com/vim/vim,src/terminal.c,src/terminal.c,2503,2499,36,33,33,29,3,4,dada6d2a8e887309e88cb126f1251d81f91b4b9d,Committer [name=Bram Moolenaar; email=Bram@vim.org]
https://github.com/vim/vim,src/normal.c,src/normal.c,7266,7243,355,344,280,275,75,69,95c83c64be8d4af74bfda1f283a5bcf3f110719e,Committer [name=Bram Moolenaar; email=Bram@vim.org]
https://github.com/vim/vim,src/screen.c,src/screen.c,8513,8527,617,619,395,396,222,223,238d43b32859d1b4e6b7072d552289a748cbfee1,Committer [name=Bram Moolenaar; email=Bram@vim.org]
https://github.com/vim/vim,src/option.c,src/option.c,10584,10576,1086,1082,750,748,336,334,4cf56bbc85f77846aeb378cfb071677336dfad6d,Committer [name=Bram Moolenaar; email=Bram@vim.org]
https://github.com/vim/vim,src/buffer.c,src/buffer.c,4781,4780,300,300,233,234,67,66,8adb0d03ca2694922da915356d7ede05e31c5a5c,Committer [name=Bram Moolenaar; email=Bram@vim.org]
https://github.com/vim/vim,src/screen.c,src/screen.c,8419,8414,540,538,343,345,197,193,f3d769a585040ac47f7054057758809024ef6377,Committer [name=Bram Moolenaar; email=Bram@vim.org]
https://github.com/vim/vim,src/term.c,src/term.c,4926,4925,363,363,295,296,68,67,a5e6621aadadf78c7b344e93a4b328788076f14c,Committer [name=Bram Moolenaar; email=Bram@vim.org]
https://github.com/vim/vim,src/dosinst.c,src/dosinst.c,1970,1957,19,0,17,0,2,0,6199d43f4b59a9bb1c87d408c5b33fa19a23ebcd,Committer [name=Bram Moolenaar; email=Bram@vim.org]
https://github.com/vim/vim,src/uninstal.c,src/uninstal.c,319,335,4,0,3,0,1,0,6199d43f4b59a9bb1c87d408c5b33fa19a23ebcd,Committer [name=Bram Moolenaar; email=Bram@vim.org]
https://github.com/vim/vim,src/term.c,src/term.c,4928,5003,363,370,296,300,67,70,65e4c4f6868882a380c319632a1728a5e7d274ad,Committer [name=Bram Moolenaar; email=Bram@vim.org]
https://github.com/vim/vim,src/terminal.c,src/terminal.c,2824,2832,41,43,30,33,11,10,65e4c4f6868882a380c319632a1728a5e7d274ad,Committer [name=Bram Moolenaar; email=Bram@vim.org]
https://github.com/vim/vim,src/evalfunc.c,src/evalfunc.c,10665,10678,504,507,472,474,32,33,7567d0b115e332f61a9f390aaccdf7825b891227,Committer [name=Bram Moolenaar; email=Bram@vim.org]
https://github.com/vim/vim,src/option.c,src/option.c,10479,10497,1030,1033,701,702,329,331,51b0f3701ecb440aa72ab6017c1df6940c0e0f6f,Committer [name=Bram Moolenaar; email=Bram@vim.org]
https://github.com/vim/vim,src/os_unix.c,src/os_unix.c,5826,5854,518,523,440,443,78,80,51b0f3701ecb440aa72ab6017c1df6940c0e0f6f,Committer [name=Bram Moolenaar; email=Bram@vim.org]
https://github.com/vim/vim,src/ex_cmds.c,src/ex_cmds.c,6323,6325,260,259,189,187,71,72,c41838aa01ef99540e2737c42e9b1283e3da5e26,Committer [name=Bram Moolenaar; email=Bram@vim.org]
https://github.com/vim/vim,src/mbyte.c,src/mbyte.c,5229,5234,136,136,121,123,15,13,819edbe078c8579f3620d12dac830f12ccdc5a45,Committer [name=Bram Moolenaar; email=Bram@vim.org]
https://github.com/vim/vim,src/ex_cmds.c,src/ex_cmds.c,6325,6325,259,259,187,188,72,71,e0aa23f7e3cc389251ecb3266926ac7d83056b1b,Committer [name=Bram Moolenaar; email=Bram@vim.org]
https://github.com/vim/vim,src/gui_w32.c,src/gui_w32.c,6438,6497,248,248,202,197,46,51,92467d3351853de769329f62121bf34d28647546,Committer [name=Bram Moolenaar; email=Bram@vim.org]
https://github.com/vim/vim,src/gui.c,src/gui.c,4021,4031,291,294,235,237,56,57,4af031dbc8d62f89c94072a406f6d2ec0e5200be,Committer [name=Bram Moolenaar; email=Bram@vim.org]
https://github.com/vim/vim,src/screen.c,src/screen.c,8449,8451,541,542,345,344,196,198,a338adcf222b6a24e26ea5ae6a2ad27f914acb38,Committer [name=Bram Moolenaar; email=Bram@vim.org]
https://github.com/vim/vim,src/ex_cmds2.c,src/ex_cmds2.c,4135,4243,211,215,192,194,19,21,c6f9f739d32084923c3031cbf6f581f8c8bf7fd2,Committer [name=Bram Moolenaar; email=Bram@vim.org]
https://github.com/vim/vim,src/misc1.c,src/misc1.c,7755,7769,246,248,175,176,71,72,cafafb381a04e33f3ce9cd15dd9f94b73226831f,Committer [name=Bram Moolenaar; email=Bram@vim.org]
https://github.com/vim/vim,src/os_win32.c,src/os_win32.c,5231,5546,196,204,159,166,37,38,cafafb381a04e33f3ce9cd15dd9f94b73226831f,Committer [name=Bram Moolenaar; email=Bram@vim.org]
https://github.com/vim/vim,src/screen.c,src/screen.c,8440,8457,542,544,345,346,197,198,cafafb381a04e33f3ce9cd15dd9f94b73226831f,Committer [name=Bram Moolenaar; email=Bram@vim.org]
https://github.com/vim/vim,src/syntax.c,src/syntax.c,7760,7753,277,275,231,230,46,45,33ef5bb0e4ea9a049c4311cfe59d1926dcb963a4,Committer [name=Bram Moolenaar; email=Bram@vim.org]
https://github.com/vim/vim,src/ex_cmds.c,src/ex_cmds.c,6329,6350,260,263,188,189,72,74,5f73ef8d20070cd45c9aea4dc33c2e0657f5515c,Committer [name=Bram Moolenaar; email=Bram@vim.org]
https://github.com/vim/vim,src/option.c,src/option.c,10519,10490,1021,1008,690,679,331,329,8a3bb56230d220b8e1b4dcca517ed95f5341b8c7,Committer [name=Bram Moolenaar; email=Bram@vim.org]
https://github.com/vim/vim,src/os_win32.c,src/os_win32.c,5544,5558,203,205,165,166,38,39,157d813be41c122e210b0eb1cd1e862fbddbf665,Committer [name=Bram Moolenaar; email=Bram@vim.org]
https://github.com/vim/vim,src/window.c,src/window.c,5276,5270,121,119,113,112,8,7,8a3bb56230d220b8e1b4dcca517ed95f5341b8c7,Committer [name=Bram Moolenaar; email=Bram@vim.org]
https://github.com/vim/vim,src/ex_docmd.c,src/ex_docmd.c,9336,9353,350,353,265,266,85,87,4d8bac8bf593ff087517ff79090c2d224325aae6,Committer [name=Bram Moolenaar; email=Bram@vim.org]
https://github.com/vim/vim,src/terminal.c,src/terminal.c,3782,3874,52,60,39,43,13,17,135682517bc378cfdb63fe3a6e3553935f69f6ce,Committer [name=Bram Moolenaar; email=Bram@vim.org]
https://github.com/vim/vim,src/buffer.c,src/buffer.c,4665,4681,235,238,184,186,51,52,0751f51a5b428805a8c1e9fe529693d032bec991,Committer [name=Bram Moolenaar; email=Bram@vim.org]
https://github.com/vim/vim,src/ex_cmds.c,src/ex_cmds.c,6270,6260,226,222,163,161,63,61,0c72fe4ed8430db41f43c5878e6ee60265dc49e9,Committer [name=Bram Moolenaar; email=Bram@vim.org]
https://github.com/vim/vim,src/ex_cmds2.c,src/ex_cmds2.c,4226,4204,203,193,181,174,22,19,0c72fe4ed8430db41f43c5878e6ee60265dc49e9,Committer [name=Bram Moolenaar; email=Bram@vim.org]
https://github.com/vim/vim,src/ex_docmd.c,src/ex_docmd.c,9373,9356,353,347,266,261,87,86,0c72fe4ed8430db41f43c5878e6ee60265dc49e9,Committer [name=Bram Moolenaar; email=Bram@vim.org]
https://github.com/vim/vim,src/fileio.c,src/fileio.c,7585,7585,393,393,298,297,95,96,333b80acf3a44e462456e6d5730e47ffa449c83d,Committer [name=Bram Moolenaar; email=Bram@vim.org]
https://github.com/vim/vim,src/channel.c,src/channel.c,4466,4475,98,100,86,87,12,13,4ac2e8d8e60dcc7dbff662e177b86ccfbda7cd9e,Committer [name=Bram Moolenaar; email=Bram@vim.org]
https://github.com/vim/vim,src/proto.h,src/proto.h,143,156,17,21,13,14,4,7,ea39176baab52b646d1e2676e662def718ddd365,Committer [name=Bram Moolenaar; email=Bram@vim.org]
https://github.com/vim/vim,src/terminal.c,src/terminal.c,4126,4126,62,62,44,45,18,17,07b46af645fa7a2b95afec3f3d87c91942d9cbd0,Committer [name=Bram Moolenaar; email=Bram@vim.org]
https://github.com/vim/vim,src/main.c,src/main.c,3100,3100,314,314,263,264,51,50,6f4700233fd925fe122b851f937929fb5e5da707,Committer [name=Bram Moolenaar; email=Bram@vim.org]
https://github.com/vim/vim,src/option.c,src/option.c,10490,10494,1008,1010,679,680,329,330,b8e22a053b68774dfd86fd829d9dba2333f09c05,Committer [name=Bram Moolenaar; email=Bram@vim.org]
https://github.com/vim/vim,src/window.c,src/window.c,5270,5270,119,119,112,113,7,6,6f4700233fd925fe122b851f937929fb5e5da707,Committer [name=Bram Moolenaar; email=Bram@vim.org]
https://github.com/vim/vim,src/option.c,src/option.c,10505,10540,1012,1020,680,682,332,338,6d150f783d5d3820fe69734dda1e79b8276a84d2,Committer [name=Bram Moolenaar; email=Bram@vim.org]
https://github.com/vim/vim,src/ui.c,src/ui.c,2488,2485,129,172,98,124,31,48,4e601e3c82899b3a8334856397946efeaa007f29,Committer [name=Bram Moolenaar; email=Bram@vim.org]
https://github.com/vim/vim,src/quickfix.c,src/quickfix.c,4538,4588,47,53,45,48,2,5,2225ebb48644f3924311b8df02a1319ab7675d42,Committer [name=Bram Moolenaar; email=Bram@vim.org]
https://github.com/vim/vim,src/term.c,src/term.c,5138,5244,373,377,302,304,71,73,c5cd88554f1e0b2e9ff08d9a0748238dd8340ce1,Committer [name=Bram Moolenaar; email=Bram@vim.org]
https://github.com/vim/vim,src/channel.c,src/channel.c,4550,4575,99,100,86,88,13,12,b0b98d523036d534755bf1cf79d1595e61c3f7ce,Committer [name=Bram Moolenaar; email=Bram@vim.org]
https://github.com/vim/vim,src/terminal.c,src/terminal.c,4287,4311,67,72,49,52,18,20,f25329cb94e481999e8b08d886cc0f0169e2020c,Committer [name=Bram Moolenaar; email=Bram@vim.org]
https://github.com/vim/vim,src/os_mswin.c,src/os_mswin.c,2173,2192,104,106,95,96,9,10,2290b1f8aaafbcb38bd801d08e8bf86cb07abfa5,Committer [name=Bram Moolenaar; email=Bram@vim.org]
https://github.com/vim/vim,src/normal.c,src/normal.c,7232,7296,322,331,256,263,66,68,f273245f6433d5d43a5671306b520a3230c35787,Committer [name=Bram Moolenaar; email=Bram@vim.org]
https://github.com/vim/vim,src/os_win32.c,src/os_win32.c,5686,5688,0,215,0,175,0,40,79c6b51e403d4ea755b6637b01d1426a06ca9f9a,Committer [name=Bram Moolenaar; email=Bram@vim.org]
https://github.com/vim/vim,src/os_win32.c,src/os_win32.c,5677,5686,211,0,172,0,39,0,493359eb3b10377d5c3524e91d911809b8ac7a76,Committer [name=Bram Moolenaar; email=Bram@vim.org]
https://github.com/vim/vim,src/normal.c,src/normal.c,7296,7298,331,331,263,264,68,67,ffa9684150f5441e84d492e7184ef73587bd6c6c,Committer [name=Bram Moolenaar; email=Bram@vim.org]
https://github.com/vim/vim,src/screen.c,src/screen.c,8492,8497,544,546,345,346,199,200,a87b72cc316e065d66dcbcf7ec1cde330adef3a3,Committer [name=Bram Moolenaar; email=Bram@vim.org]
https://github.com/vim/vim,src/ops.c,src/ops.c,5843,5855,228,230,164,165,64,65,630afe889a2a02b367ea8eaaa48e66ed81e77ff3,Committer [name=Bram Moolenaar; email=Bram@vim.org]
https://github.com/vim/vim,src/term.c,src/term.c,5273,5276,378,378,305,304,73,74,e330ef42f256e60017e5f8bf4be79a5308fe9e2f,Committer [name=Bram Moolenaar; email=Bram@vim.org]
https://github.com/vim/vim,src/normal.c,src/normal.c,7298,7292,331,331,264,265,67,66,0a08c63da17dfd93ac2885e3f3f8a083a9b3131c,Committer [name=Bram Moolenaar; email=Bram@vim.org]
https://github.com/vim/vim,src/edit.c,src/edit.c,7959,7885,435,401,292,275,143,126,1f0bfe561737cd445532f20d7607a81d1dadddee,Committer [name=Bram Moolenaar; email=Bram@vim.org]
https://github.com/vim/vim,src/evalfunc.c,src/evalfunc.c,11153,11149,532,530,496,495,36,35,1f0bfe561737cd445532f20d7607a81d1dadddee,Committer [name=Bram Moolenaar; email=Bram@vim.org]
https://github.com/vim/vim,src/misc1.c,src/misc1.c,7968,7948,292,283,219,214,73,69,1f0bfe561737cd445532f20d7607a81d1dadddee,Committer [name=Bram Moolenaar; email=Bram@vim.org]
https://github.com/vim/vim,src/fileio.c,src/fileio.c,7640,7624,398,392,300,296,98,96,d569bb029983cff947dce704e6f830276204c13f,Committer [name=Bram Moolenaar; email=Bram@vim.org]
https://github.com/vim/vim,src/gui_gtk.c,src/gui_gtk.c,2130,2122,221,217,195,193,26,24,25328e39d2a6e3ded82bf282a2e248ce7209f1b4,Committer [name=Bram Moolenaar; email=Bram@vim.org]
https://github.com/vim/vim,src/gui_gtk_x11.c,src/gui_gtk_x11.c,5443,5321,245,398,213,334,32,64,25328e39d2a6e3ded82bf282a2e248ce7209f1b4,Committer [name=Bram Moolenaar; email=Bram@vim.org]
https://github.com/vim/vim,src/move.c,src/move.c,2221,2236,186,188,117,118,69,70,90a997987dbbe43af3c15118a35f658f0f037d1d,Committer [name=Bram Moolenaar; email=Bram@vim.org]
https://github.com/vim/vim,src/workshop.c,src/workshop.c,1416,1414,0,51,0,50,0,1,32d19c1820305729c0d1b21536b18bae2d8378ed,Committer [name=Bram Moolenaar; email=Bram@vim.org]
https://github.com/vim/vim,src/buffer.c,src/buffer.c,4736,4724,240,235,190,186,50,49,8aeb504fc68e3fea9da5567d2d9a31a132fbf90f,Committer [name=Bram Moolenaar; email=Bram@vim.org]
https://github.com/vim/vim,src/gui_gtk.c,src/gui_gtk.c,2122,1946,217,151,193,133,24,18,664323e7c82c35eabb9056efca0df6cc8d6cfd60,Committer [name=Bram Moolenaar; email=Bram@vim.org]
https://github.com/vim/vim,src/gui_gtk_f.c,src/gui_gtk_f.c,804,673,90,42,66,42,24,0,664323e7c82c35eabb9056efca0df6cc8d6cfd60,Committer [name=Bram Moolenaar; email=Bram@vim.org]
https://github.com/vim/vim,src/gui_gtk_x11.c,src/gui_gtk_x11.c,5321,4987,398,263,334,242,64,21,664323e7c82c35eabb9056efca0df6cc8d6cfd60,Committer [name=Bram Moolenaar; email=Bram@vim.org]
https://github.com/vim/vim,src/gui_gtk_x11.c,src/gui_gtk_x11.c,4987,4999,263,269,242,247,21,22,92cbf62b872c2cfccb2fe4f9c46881c69d488c8a,Committer [name=Bram Moolenaar; email=Bram@vim.org]
https://github.com/vim/vim,src/term.c,src/term.c,5308,5333,377,383,303,308,74,75,35bc7d6c52f516b60d683bf9f0f57266d86e25b9,Committer [name=Bram Moolenaar; email=Bram@vim.org]
https://github.com/vim/vim,src/option.c,src/option.c,10999,11026,1041,1043,704,705,337,338,f951416a8396a54bbbe21de1a8b16716428549f2,Committer [name=Bram Moolenaar; email=Bram@vim.org]
https://github.com/vim/vim,src/screen.c,src/screen.c,8511,8596,546,551,346,350,200,201,98aefe7c3250bb5d4153b994f878594d1745424e,Committer [name=Bram Moolenaar; email=Bram@vim.org]
https://github.com/vim/vim,src/buffer.c,src/buffer.c,4939,4472,235,230,186,182,49,48,bbea47075cc4e7826e9f8c203e4272ba023ed7b0,Committer [name=Bram Moolenaar; email=Bram@vim.org]
https://github.com/vim/vim,src/ex_cmds.c,src/ex_cmds.c,6666,5720,232,221,171,161,61,60,bbea47075cc4e7826e9f8c203e4272ba023ed7b0,Committer [name=Bram Moolenaar; email=Bram@vim.org]
https://github.com/vim/vim,src/version.c,src/version.c,1991,2000,356,358,355,356,1,2,c85ffc9daba6f66d5958ae80249d26f7f81bfced,Committer [name=Bram Moolenaar; email=Bram@vim.org]
https://github.com/vim/vim,src/ui.c,src/ui.c,2489,2507,172,176,124,126,48,50,c46af534102c65b43912311d67f55f5049e5ef7a,Committer [name=Bram Moolenaar; email=Bram@vim.org]
https://github.com/vim/vim,src/gui_beval.c,src/gui_beval.c,929,921,70,66,67,65,3,1,c951522943fc7c1eedaa707d2fa06da5ca17545a,Committer [name=Bram Moolenaar; email=Bram@vim.org]
https://github.com/vim/vim,src/normal.c,src/normal.c,7279,7271,327,323,261,259,66,64,870ba5f6dce974b6c1c47bf9d3b20db805d10b36,Committer [name=Bram Moolenaar; email=Bram@vim.org]
https://github.com/vim/vim,src/buffer.c,src/buffer.c,4489,4463,233,220,185,178,48,42,135059724f140ceac889c9f8136bd1bf5c41d49d,Committer [name=Bram Moolenaar; email=Bram@vim.org]
https://github.com/vim/vim,src/charset.c,src/charset.c,1574,1499,78,42,51,26,27,16,135059724f140ceac889c9f8136bd1bf5c41d49d,Committer [name=Bram Moolenaar; email=Bram@vim.org]
https://github.com/vim/vim,src/diff.c,src/diff.c,2405,2394,38,33,30,26,8,7,135059724f140ceac889c9f8136bd1bf5c41d49d,Committer [name=Bram Moolenaar; email=Bram@vim.org]
https://github.com/vim/vim,src/digraph.c,src/digraph.c,2399,2251,30,19,23,16,7,3,135059724f140ceac889c9f8136bd1bf5c41d49d,Committer [name=Bram Moolenaar; email=Bram@vim.org]
https://github.com/vim/vim,src/edit.c,src/edit.c,7937,7772,404,329,278,249,126,80,135059724f140ceac889c9f8136bd1bf5c41d49d,Committer [name=Bram Moolenaar; email=Bram@vim.org]
https://github.com/vim/vim,src/gui_w32.c,src/gui_w32.c,6591,6420,250,198,199,161,51,37,fc3abf47fbe1e426f2b676c316c81ee9ff607075,Committer [name=Bram Moolenaar; email=Bram@vim.org]
https://github.com/vim/vim,src/eval.c,src/eval.c,8236,8222,106,99,85,81,21,18,135059724f140ceac889c9f8136bd1bf5c41d49d,Committer [name=Bram Moolenaar; email=Bram@vim.org]
https://github.com/vim/vim,src/gui_x11.c,src/gui_x11.c,2500,2478,110,100,86,82,24,18,fc3abf47fbe1e426f2b676c316c81ee9ff607075,Committer [name=Bram Moolenaar; email=Bram@vim.org]
https://github.com/vim/vim,src/os_mswin.c,src/os_mswin.c,2211,2159,106,81,96,73,10,8,a12a161b8ce09d024ed71c2134149fa323f8ee8e,Committer [name=Bram Moolenaar; email=Bram@vim.org]
https://github.com/vim/vim,src/evalfunc.c,src/evalfunc.c,11847,11764,525,488,489,461,36,27,135059724f140ceac889c9f8136bd1bf5c41d49d,Committer [name=Bram Moolenaar; email=Bram@vim.org]
https://github.com/vim/vim,src/hardcopy.c,src/hardcopy.c,2607,2512,70,24,42,16,28,8,fc3abf47fbe1e426f2b676c316c81ee9ff607075,Committer [name=Bram Moolenaar; email=Bram@vim.org]
https://github.com/vim/vim,src/os_unix.c,src/os_unix.c,5949,5929,535,526,455,451,80,75,a12a161b8ce09d024ed71c2134149fa323f8ee8e,Committer [name=Bram Moolenaar; email=Bram@vim.org]
https://github.com/vim/vim,src/ex_cmds.c,src/ex_cmds.c,5719,5664,220,194,160,140,60,54,135059724f140ceac889c9f8136bd1bf5c41d49d,Committer [name=Bram Moolenaar; email=Bram@vim.org]
https://github.com/vim/vim,src/json.c,src/json.c,956,931,22,11,17,7,5,4,fc3abf47fbe1e426f2b676c316c81ee9ff607075,Committer [name=Bram Moolenaar; email=Bram@vim.org]
https://github.com/vim/vim,src/os_win32.c,src/os_win32.c,5813,5701,219,165,179,147,40,18,a12a161b8ce09d024ed71c2134149fa323f8ee8e,Committer [name=Bram Moolenaar; email=Bram@vim.org]
https://github.com/vim/vim,src/getchar.c,src/getchar.c,3844,3780,167,138,119,98,48,40,264b74fa545edfb92c0d7d08a02c26331cc5b168,Committer [name=Bram Moolenaar; email=Bram@vim.org]
https://github.com/vim/vim,src/quickfix.c,src/quickfix.c,5222,5189,55,40,50,37,5,3,a12a161b8ce09d024ed71c2134149fa323f8ee8e,Committer [name=Bram Moolenaar; email=Bram@vim.org]
https://github.com/vim/vim,src/ex_docmd.c,src/ex_docmd.c,9571,9528,355,336,268,260,87,76,135059724f140ceac889c9f8136bd1bf5c41d49d,Committer [name=Bram Moolenaar; email=Bram@vim.org]
https://github.com/vim/vim,src/regexp.c,src/regexp.c,6482,6347,143,77,101,67,42,10,a12a161b8ce09d024ed71c2134149fa323f8ee8e,Committer [name=Bram Moolenaar; email=Bram@vim.org]
https://github.com/vim/vim,src/ex_getln.c,src/ex_getln.c,5786,5721,237,205,183,165,54,40,135059724f140ceac889c9f8136bd1bf5c41d49d,Committer [name=Bram Moolenaar; email=Bram@vim.org]
https://github.com/vim/vim,src/regexp_nfa.c,src/regexp_nfa.c,5749,5686,141,114,121,106,20,8,a12a161b8ce09d024ed71c2134149fa323f8ee8e,Committer [name=Bram Moolenaar; email=Bram@vim.org]
https://github.com/vim/vim,src/fileio.c,src/fileio.c,7625,7544,398,356,298,265,100,91,135059724f140ceac889c9f8136bd1bf5c41d49d,Committer [name=Bram Moolenaar; email=Bram@vim.org]
https://github.com/vim/vim,src/fold.c,src/fold.c,2419,2415,17,15,14,13,3,2,135059724f140ceac889c9f8136bd1bf5c41d49d,Committer [name=Bram Moolenaar; email=Bram@vim.org]
https://github.com/vim/vim,src/screen.c,src/screen.c,8610,8352,552,431,348,265,204,166,a12a161b8ce09d024ed71c2134149fa323f8ee8e,Committer [name=Bram Moolenaar; email=Bram@vim.org]
https://github.com/vim/vim,src/message.c,src/message.c,3829,3747,175,140,108,87,67,53,fc3abf47fbe1e426f2b676c316c81ee9ff607075,Committer [name=Bram Moolenaar; email=Bram@vim.org]
https://github.com/vim/vim,src/gui.c,src/gui.c,4014,3976,283,264,229,212,54,52,135059724f140ceac889c9f8136bd1bf5c41d49d,Committer [name=Bram Moolenaar; email=Bram@vim.org]
https://github.com/vim/vim,src/misc1.c,src/misc1.c,7948,7858,289,249,219,191,70,58,fc3abf47fbe1e426f2b676c316c81ee9ff607075,Committer [name=Bram Moolenaar; email=Bram@vim.org]
https://github.com/vim/vim,src/gui_mac.c,src/gui_mac.c,4355,4301,125,99,117,94,8,5,135059724f140ceac889c9f8136bd1bf5c41d49d,Committer [name=Bram Moolenaar; email=Bram@vim.org]
https://github.com/vim/vim,src/misc2.c,src/misc2.c,4737,4695,243,224,186,174,57,50,fc3abf47fbe1e426f2b676c316c81ee9ff607075,Committer [name=Bram Moolenaar; email=Bram@vim.org]
https://github.com/vim/vim,src/gui_photon.c,src/gui_photon.c,2216,2204,42,38,38,36,4,2,135059724f140ceac889c9f8136bd1bf5c41d49d,Committer [name=Bram Moolenaar; email=Bram@vim.org]
https://github.com/vim/vim,src/screen.c,src/screen.c,8352,8324,431,426,265,264,166,162,9ba6117de6dc2993f8b42ccb9754c23694db2950,Committer [name=Bram Moolenaar; email=Bram@vim.org]
https://github.com/vim/vim,src/normal.c,src/normal.c,7271,7199,323,288,259,235,64,53,fc3abf47fbe1e426f2b676c316c81ee9ff607075,Committer [name=Bram Moolenaar; email=Bram@vim.org]
https://github.com/vim/vim,src/search.c,src/search.c,4396,4343,135,110,89,76,46,34,264b74fa545edfb92c0d7d08a02c26331cc5b168,Committer [name=Bram Moolenaar; email=Bram@vim.org]
https://github.com/vim/vim,src/ops.c,src/ops.c,5831,5739,224,181,156,132,68,49,fc3abf47fbe1e426f2b676c316c81ee9ff607075,Committer [name=Bram Moolenaar; email=Bram@vim.org]
https://github.com/vim/vim,src/spell.c,src/spell.c,6427,6263,117,40,65,31,52,9,264b74fa545edfb92c0d7d08a02c26331cc5b168,Committer [name=Bram Moolenaar; email=Bram@vim.org]
https://github.com/vim/vim,src/option.c,src/option.c,11058,10899,1046,973,709,658,337,315,fc3abf47fbe1e426f2b676c316c81ee9ff607075,Committer [name=Bram Moolenaar; email=Bram@vim.org]
https://github.com/vim/vim,src/spellfile.c,src/spellfile.c,4745,4655,52,11,34,7,18,4,264b74fa545edfb92c0d7d08a02c26331cc5b168,Committer [name=Bram Moolenaar; email=Bram@vim.org]
https://github.com/vim/vim,src/structs.h,src/structs.h,2334,2318,211,203,152,148,59,55,264b74fa545edfb92c0d7d08a02c26331cc5b168,Committer [name=Bram Moolenaar; email=Bram@vim.org]
https://github.com/vim/vim,src/term.c,src/term.c,5339,5325,384,377,309,305,75,72,264b74fa545edfb92c0d7d08a02c26331cc5b168,Committer [name=Bram Moolenaar; email=Bram@vim.org]
https://github.com/vim/vim,src/ui.c,src/ui.c,2511,2422,178,139,128,100,50,39,264b74fa545edfb92c0d7d08a02c26331cc5b168,Committer [name=Bram Moolenaar; email=Bram@vim.org]
https://github.com/vim/vim,src/version.c,src/version.c,2121,2116,354,351,352,350,2,1,264b74fa545edfb92c0d7d08a02c26331cc5b168,Committer [name=Bram Moolenaar; email=Bram@vim.org]
https://github.com/vim/vim,src/fileio.c,src/fileio.c,7534,5725,352,306,263,221,89,85,3e460fd8b72db905fbf9f01b00371384ffc415b8,Committer [name=Bram Moolenaar; email=Bram@vim.org]
https://github.com/vim/vim,src/os_unix.c,src/os_unix.c,5929,5959,526,526,451,453,75,73,1ecc5e4a995ade68ae216bb56f6ac9bd5c0b7e4b,Committer [name=Bram Moolenaar; email=Bram@vim.org]
https://github.com/vim/vim,src/winclip.c,src/winclip.c,548,534,18,11,15,10,3,1,264b74fa545edfb92c0d7d08a02c26331cc5b168,Committer [name=Bram Moolenaar; email=Bram@vim.org]
https://github.com/vim/vim,src/gui.c,src/gui.c,3974,3956,263,260,211,209,52,51,e40b9d47bf8f8f716d3ef5a95c8ecbbdc0a501f9,Committer [name=Bram Moolenaar; email=Bram@vim.org]
https://github.com/vim/vim,src/os_unix.c,src/os_unix.c,5959,5882,526,518,453,447,73,71,e40b9d47bf8f8f716d3ef5a95c8ecbbdc0a501f9,Committer [name=Bram Moolenaar; email=Bram@vim.org]
https://github.com/vim/vim,src/ui.c,src/ui.c,2420,2533,138,147,99,106,39,41,e40b9d47bf8f8f716d3ef5a95c8ecbbdc0a501f9,Committer [name=Bram Moolenaar; email=Bram@vim.org]
https://github.com/vim/vim,src/edit.c,src/edit.c,7737,7502,314,302,240,235,74,67,4b47162ccede0b6d9cbb9473ad870220a24fbf54,Committer [name=Bram Moolenaar; email=Bram@vim.org]
https://github.com/vim/vim,src/misc1.c,src/misc1.c,7843,5018,242,236,185,180,57,56,4b47162ccede0b6d9cbb9473ad870220a24fbf54,Committer [name=Bram Moolenaar; email=Bram@vim.org]
https://github.com/vim/vim,src/if_ruby.c,src/if_ruby.c,1322,1326,118,120,114,115,4,5,63d1fea8141c3dfb36aeb9de60e5f1f90450acff,Committer [name=Bram Moolenaar; email=Bram@vim.org]
https://github.com/vim/vim,src/option.c,src/option.c,10948,10972,969,972,656,657,313,315,aa5df7e3127dff6b7336df0903f5c569a40eb174,Committer [name=Bram Moolenaar; email=Bram@vim.org]
https://github.com/vim/vim,src/misc1.c,src/misc1.c,5018,4747,236,229,180,175,56,54,5fd0f5052f9a312bb4cfe7b4176b1211d45127ee,Committer [name=Bram Moolenaar; email=Bram@vim.org]
https://github.com/vim/vim,src/misc2.c,src/misc2.c,4685,3399,211,142,164,119,47,23,5fd0f5052f9a312bb4cfe7b4176b1211d45127ee,Committer [name=Bram Moolenaar; email=Bram@vim.org]
https://github.com/vim/vim,src/fileio.c,src/fileio.c,5713,5726,302,304,222,223,80,81,a787019518a540a7b4d0070f15467931b870ac89,Committer [name=Bram Moolenaar; email=Bram@vim.org]
https://github.com/vim/vim,src/os_mswin.c,src/os_mswin.c,2299,2303,81,81,73,75,8,6,9b5c1fcdeae75f82a2083fafbbf75ab220f6ac1e,Committer [name=Bram Moolenaar; email=Bram@vim.org]
